//MAP CONVERTED BY dmm2tgm.py THIS HEADER COMMENT PREVENTS RECONVERSION, DO NOT REMOVE
"a" = (
/obj/structure/table/wood{
	dir = 1;
	icon_state = "tablewood1"
	},
/obj/item/candle/yellow,
/turf/open/floor/cobble,
/area/indoors/town)
"d" = (
/obj/structure/closet/crate/drawer,
/obj/item/coin/copper/pile,
/turf/open/floor/wood,
/area/indoors/town)
"f" = (
/obj/structure/bed/mediocre,
/obj/item/bedsheet/wool,
/turf/open/floor/wood,
/area/indoors/town)
"g" = (
/obj/structure/rack/shelf/biggest,
/turf/open/floor/twig,
/area/indoors/town)
"h" = (
/obj/machinery/light/fueled/wallfire/candle,
/obj/structure/bed/mediocre,
/obj/item/bedsheet/wool,
/turf/open/floor/wood,
/area/indoors/town)
"k" = (
/obj/structure/ladder,
/turf/open/floor/twig,
/area/indoors/town)
"n" = (
/obj/machinery/light/fueled/wallfire/candle/l,
/turf/open/floor/twig,
/area/indoors/town)
"o" = (
/obj/structure/door{
	lockid = "house5";
	name = "House V"
	},
/turf/open/floor/wood,
/area/indoors/town)
"p" = (
/obj/structure/chair/stool,
/turf/open/floor/twig,
/area/indoors/town)
"q" = (
/obj/structure/curtain/bounty{
	color = "grey"
	},
/obj/structure/window/openclose{
	dir = 8
	},
/turf/open/floor/twig,
/area/indoors/town)
"u" = (
/obj/structure/window/openclose,
/obj/structure/curtain/bounty{
	color = "grey"
	},
/turf/open/floor/twig,
/area/indoors/town)
"v" = (
/obj/structure/curtain/bounty{
	color = "grey"
	},
/turf/closed/wall/mineral/wood/window,
/area/indoors/town)
"w" = (
/turf/closed/wall/mineral/wooddark,
/area/indoors/town)
"A" = (
/turf/open/floor/wood,
/area/indoors/town)
"D" = (
/obj/effect/decal/cleanable/dirt/dust,
/turf/open/floor/wood,
/area/indoors/town)
"F" = (
/turf/open/floor/twig,
/area/indoors/town)
"G" = (
/obj/structure/door{
	name = "Bedroom"
	},
/turf/open/floor/wood,
/area/indoors/town)
"J" = (
/obj/machinery/light/fueled/hearth,
/obj/item/cooking/pan,
/turf/open/floor/cobble,
/area/indoors/town)
"K" = (
/obj/structure/ladder,
/obj/machinery/light/fueled/wallfire/candle,
/turf/open/floor/wood,
/area/indoors/town)
"M" = (
/turf/closed/wall/mineral/wood,
/area/indoors/town)
"N" = (
/obj/effect/decal/cobbleedge{
	dir = 10;
	pixel_y = 1
	},
/obj/structure/chair/wood/alt,
/turf/open/floor/twig,
/area/indoors/town)
"P" = (
/obj/structure/window/openclose{
	dir = 1
	},
/obj/structure/curtain/bounty{
	color = "grey"
	},
/turf/open/floor/twig,
/area/indoors/town)
"T" = (
/obj/structure/curtain/bounty{
	color = "grey"
	},
/obj/structure/window/openclose{
	dir = 4
	},
/turf/open/floor/twig,
/area/indoors/town)
"U" = (
/obj/item/reagent_containers/glass/carafe,
/obj/item/storage/sack,
/obj/item/reagent_containers/glass/bucket/pot{
	pixel_y = 4
	},
/obj/structure/closet/crate/chest/crafted,
/turf/open/floor/twig,
/area/indoors/town)
"W" = (
/obj/structure/closet/crate/crafted_closet,
/obj/item/natural/cloth,
/obj/item/natural/cloth,
/obj/item/coin/copper/pile,
/obj/item/candle/yellow,
/obj/item/broom,
/obj/item/reagent_containers/glass/bucket/pot{
	pixel_y = 4
	},
/obj/item/key/houses/house4,
/turf/open/floor/wood,
/area/indoors/town)
"X" = (
/obj/effect/decal/cleanable/dirt/dust,
/obj/structure/closet/crate/chest/crafted,
/obj/item/clothing/cloak/poncho,
/turf/open/floor/wood,
/area/indoors/town)
"Y" = (
/obj/structure/sign/property_sign/claim,
/turf/closed/wall/mineral/wood,
/area/indoors/town)

(1,1,1) = {"
w
M
M
M
w
"}
(2,1,1) = {"
M
k
n
U
M
"}
(3,1,1) = {"
v
g
F
F
v
"}
(4,1,1) = {"
v
p
F
F
v
"}
(5,1,1) = {"
M
J
F
F
Y
"}
(6,1,1) = {"
M
a
N
F
o
"}
(7,1,1) = {"
w
M
v
M
w
"}

(1,1,2) = {"
M
M
T
M
M
"}
(2,1,2) = {"
M
K
D
A
P
"}
(3,1,2) = {"
M
A
A
W
P
"}
(4,1,2) = {"
M
M
G
M
M
"}
(5,1,2) = {"
M
h
D
f
P
"}
(6,1,2) = {"
u
d
D
X
P
"}
(7,1,2) = {"
M
M
q
M
M
"}
