//MAP CONVERTED BY dmm2tgm.py THIS HEADER COMMENT PREVENTS RECONVERSION, DO NOT REMOVE
"a" = (
/turf/closed/wall/mineral/wood,
/area/indoors/town)
"b" = (
/obj/item/weapon/shovel{
	pixel_x = -1;
	pixel_y = 8
	},
/obj/item/weapon/chisel,
/obj/item/weapon/pick/stone,
/obj/item/weapon/shovel/small,
/obj/effect/decal/cleanable/dirt/dust,
/turf/open/floor/blocks/stonered/tiny,
/area/indoors/town)
"d" = (
/obj/machinery/light/fueled/hearth,
/obj/item/cooking/pan,
/turf/open/floor/cobble,
/area/indoors/town)
"e" = (
/obj/structure/curtain/bounty{
	color = "grey"
	},
/obj/structure/window/openclose{
	dir = 4
	},
/turf/open/floor/ruinedwood/two,
/area/indoors/town)
"f" = (
/obj/effect/decal/cobbleedge{
	dir = 6
	},
/turf/open/floor/twig,
/area/indoors/town)
"g" = (
/obj/structure/window/openclose,
/obj/structure/curtain/bounty{
	color = "grey"
	},
/turf/open/floor/ruinedwood/two,
/area/indoors/town)
"i" = (
/obj/effect/decal/cobbleedge{
	dir = 5
	},
/obj/effect/decal/cleanable/dirt/dust,
/turf/open/floor/twig,
/area/indoors/town)
"k" = (
/obj/structure/window/openclose{
	dir = 1
	},
/obj/structure/curtain/bounty{
	color = "grey"
	},
/turf/open/floor/ruinedwood/two,
/area/indoors/town)
"l" = (
/obj/structure/chair/stool,
/obj/effect/decal/cleanable/dirt/dust,
/turf/open/floor/wood,
/area/indoors/town)
"n" = (
/obj/structure/ladder,
/turf/open/floor/blocks/stonered/tiny,
/area/indoors/town)
"o" = (
/turf/open/floor/twig,
/area/indoors/town)
"p" = (
/obj/structure/closet/crate/chest/crafted,
/obj/effect/decal/cleanable/dirt/dust,
/turf/open/floor/wood,
/area/indoors/town)
"q" = (
/obj/structure/ladder,
/turf/open/floor/wood,
/area/indoors/town)
"s" = (
/obj/structure/table/wood/plain,
/obj/item/flashlight/flare/torch/lantern,
/obj/item/flashlight/flare/torch/lantern,
/obj/effect/decal/cleanable/dirt/dust,
/turf/open/floor/blocks/stonered/tiny,
/area/indoors/town)
"t" = (
/obj/structure/curtain/bounty{
	color = "grey"
	},
/obj/structure/window/openclose{
	dir = 8
	},
/turf/open/floor/ruinedwood/two,
/area/indoors/town)
"u" = (
/obj/structure/curtain/bounty{
	color = "grey"
	},
/turf/closed/wall/mineral/wood/window,
/area/indoors/town)
"v" = (
/obj/effect/decal/cleanable/dirt/dust,
/turf/open/floor/blocks/stonered/tiny,
/area/indoors/town)
"w" = (
/turf/closed/wall/mineral/wooddark,
/area/indoors/town)
"y" = (
/obj/structure/chair/stool,
/obj/effect/decal/cleanable/dirt/dust,
/turf/open/floor/cobble,
/area/indoors/town)
"A" = (
/obj/structure/table/wood{
	dir = 1;
	icon_state = "tablewood1"
	},
/obj/item/candle/yellow,
/turf/open/floor/twig,
/area/indoors/town)
"C" = (
/obj/structure/door{
	lockid = "house3";
	name = "House III"
	},
/turf/open/floor/twig,
/area/indoors/town)
"D" = (
/turf/closed/wall/mineral/stone/moss,
/area/indoors/town)
"F" = (
/obj/structure/sign/property_sign/claim,
/turf/closed/wall/mineral/wood,
/area/indoors/town)
"G" = (
/turf/open/floor/wood,
/area/indoors/town)
"H" = (
/obj/structure/bed/mediocre,
/obj/item/bedsheet/wool,
/obj/machinery/light/fueled/wallfire/candle,
/turf/open/floor/wood,
/area/indoors/town)
"I" = (
/obj/item/natural/stone,
/obj/effect/decal/cleanable/dirt/dust,
/turf/open/floor/blocks/stonered/tiny,
/area/indoors/town)
"J" = (
/obj/effect/mapping_helpers/access/locker,
/obj/structure/door{
	lockid = "house3";
	name = "House III"
	},
/turf/open/floor/blocks/stonered/tiny,
/area/indoors/town)
"K" = (
/obj/effect/decal/cobbleedge{
	dir = 6
	},
/obj/effect/decal/cleanable/dirt/dust,
/turf/open/floor/twig,
/area/indoors/town)
"L" = (
/turf/open/floor/blocks/stonered/tiny,
/area/indoors/town)
"N" = (
/obj/structure/ladder,
/obj/machinery/light/fueled/wallfire/candle,
/turf/open/floor/twig,
/area/indoors/town)
"O" = (
/obj/machinery/light/fueled/wallfire/candle,
/obj/structure/handcart{
	dir = 4
	},
/obj/effect/decal/cleanable/dirt/dust,
/turf/open/floor/blocks/stonered/tiny,
/area/indoors/town)
"P" = (
/obj/effect/decal/cleanable/dirt/dust,
/obj/effect/decal/cleanable/dirt/dust,
/turf/open/floor/blocks/stonered/tiny,
/area/indoors/town)
"Q" = (
/obj/structure/closet/crate/crafted_closet,
/obj/item/natural/cloth,
/obj/item/natural/cloth,
/obj/item/coin/copper/pile,
/obj/item/candle/yellow,
/obj/item/broom,
/obj/item/reagent_containers/glass/bucket/pot{
	pixel_y = 4
	},
/obj/item/key/houses/house3,
/turf/open/floor/wood,
/area/indoors/town)
"S" = (
/obj/structure/closet/crate/drawer,
/obj/item/coin/copper/pile,
/turf/open/floor/wood,
/area/indoors/town)
"T" = (
/obj/machinery/light/fueled/wallfire/candle/l,
/obj/structure/closet/crate/crafted_closet/dark,
/obj/effect/decal/cleanable/dirt/dust,
/turf/open/floor/blocks/stonered/tiny,
/area/indoors/town)
"U" = (
/obj/effect/decal/cleanable/dirt/dust,
/turf/open/floor/twig,
/area/indoors/town)
"V" = (
/obj/effect/decal/cleanable/dirt/dust,
/turf/open/floor/wood,
/area/indoors/town)
"W" = (
/obj/structure/rack/shelf/biggest,
/obj/item/reagent_containers/glass/carafe,
/obj/item/storage/sack,
/obj/item/reagent_containers/glass/bucket/pot{
	pixel_y = 4
	},
/turf/open/floor/blocks/stonered/tiny,
/area/indoors/town)

(1,1,1) = {"
D
D
D
D
D
"}
(2,1,1) = {"
D
n
L
T
D
"}
(3,1,1) = {"
D
I
v
b
D
"}
(4,1,1) = {"
D
s
P
v
D
"}
(5,1,1) = {"
D
O
v
I
D
"}
(6,1,1) = {"
D
D
D
J
D
"}

(1,1,2) = {"
w
a
u
a
w
"}
(2,1,2) = {"
a
N
i
d
a
"}
(3,1,2) = {"
u
A
U
y
u
"}
(4,1,2) = {"
a
U
U
K
a
"}
(5,1,2) = {"
a
W
o
f
a
"}
(6,1,2) = {"
w
a
C
F
w
"}

(1,1,3) = {"
w
a
e
a
w
"}
(2,1,3) = {"
a
q
p
l
a
"}
(3,1,3) = {"
g
G
V
V
k
"}
(4,1,3) = {"
g
V
V
V
k
"}
(5,1,3) = {"
a
H
S
Q
a
"}
(6,1,3) = {"
w
a
t
a
w
"}
