//MAP CONVERTED BY dmm2tgm.py THIS HEADER COMMENT PREVENTS RECONVERSION, DO NOT REMOVE
"a" = (
/turf/closed/wall/mineral/wood,
/area/indoors/town)
"b" = (
/obj/structure/window,
/obj/structure/curtain/bounty/dir,
/turf/open/floor/twig,
/area/indoors/town)
"d" = (
/turf/open/floor/wood,
/area/indoors/town)
"e" = (
/obj/structure/curtain/bounty{
	color = "grey"
	},
/obj/structure/window/openclose{
	dir = 4
	},
/turf/open/floor/wood,
/area/indoors/town)
"i" = (
/turf/open/floor/twig,
/area/indoors/town)
"j" = (
/obj/structure/window,
/obj/structure/curtain/bounty/dir{
	dir = 1
	},
/turf/open/floor/twig,
/area/indoors/town)
"o" = (
/obj/effect/decal/cleanable/dirt/dust,
/turf/open/floor/wood,
/area/indoors/town)
"t" = (
/obj/effect/decal/cleanable/dirt/dust,
/obj/structure/table/wood/plain_alt,
/obj/item/reagent_containers/glass/carafe/silver,
/obj/item/cooking/pan,
/obj/item/storage/sack,
/turf/open/floor/twig,
/area/indoors/town)
"u" = (
/obj/structure/window,
/obj/structure/curtain/bounty/dir{
	dir = 8
	},
/turf/open/floor/twig,
/area/indoors/town)
"v" = (
/obj/structure/door{
	lockid = "house1";
	name = "House I"
	},
/turf/open/floor/twig,
/area/indoors/town)
"x" = (
/turf/open/openspace,
/area/indoors/town)
"y" = (
/turf/closed/wall/mineral/stone/moss,
/area/indoors/town)
"B" = (
/obj/structure/chair/wood/alt{
	dir = 4
	},
/turf/open/floor/wood,
/area/indoors/town)
"C" = (
/obj/structure/fake_machine/scomm/r,
/turf/open/floor/twig,
/area/indoors/town)
"D" = (
/obj/machinery/light/fueled/torchholder{
	dir = 4
	},
/obj/structure/chair/wood/alt{
	dir = 4
	},
/turf/open/floor/twig,
/area/indoors/town)
"F" = (
/obj/machinery/light/fueled/hearth,
/obj/item/reagent_containers/glass/bucket/pot{
	pixel_y = 4
	},
/turf/open/floor/twig,
/area/indoors/town)
"G" = (
/obj/structure/sign/property_sign/claim,
/turf/closed/wall/mineral/stone/moss,
/area/indoors/town)
"I" = (
/obj/structure/door{
	lockid = "house1";
	name = "House I"
	},
/obj/effect/mapping_helpers/access/locker,
/turf/open/floor/wood,
/area/indoors/town)
"J" = (
/obj/structure/closet/crate/crafted_closet,
/obj/item/natural/cloth,
/obj/item/natural/cloth,
/obj/item/coin/copper/pile,
/obj/item/candle/yellow,
/obj/item/key/houses/house1,
/turf/open/floor/wood,
/area/indoors/town)
"L" = (
/obj/effect/decal/cleanable/dirt/dust,
/turf/open/floor/twig,
/area/indoors/town)
"M" = (
/obj/structure/stairs{
	dir = 1
	},
/turf/open/floor/twig,
/area/indoors/town)
"P" = (
/obj/structure/curtain/bounty{
	color = "grey"
	},
/turf/closed/wall/mineral/wood/window,
/area/indoors/town)
"R" = (
/obj/structure/bed/mediocre,
/obj/item/bedsheet/cloth,
/obj/structure/fluff/railing/wood{
	dir = 4
	},
/turf/open/floor/wood,
/area/indoors/town)
"T" = (
/obj/structure/bookcase/random,
/turf/open/floor/wood,
/area/indoors/town)
"W" = (
/obj/structure/table/wood/plain_alt,
/turf/open/floor/wood,
/area/indoors/town)
"Y" = (
/obj/structure/door{
	lockid = "house1";
	name = "House I"
	},
/obj/effect/mapping_helpers/access/locker,
/turf/open/floor/twig,
/area/indoors/town)
"Z" = (
/obj/structure/closet/crate/crafted_closet,
/obj/item/broom,
/turf/open/floor/twig,
/area/indoors/town)

(1,1,1) = {"
y
y
y
y
y
y
"}
(2,1,1) = {"
Y
i
t
D
L
v
"}
(3,1,1) = {"
b
i
i
C
i
G
"}
(4,1,1) = {"
y
F
Z
y
M
j
"}
(5,1,1) = {"
y
u
u
y
y
y
"}

(1,1,2) = {"
a
I
e
e
a
a
"}
(2,1,2) = {"
a
d
d
B
T
P
"}
(3,1,2) = {"
a
W
d
d
R
a
"}
(4,1,2) = {"
a
J
o
M
x
P
"}
(5,1,2) = {"
a
a
a
a
a
a
"}
