//MAP CONVERTED BY dmm2tgm.py THIS HEADER COMMENT PREVENTS RECONVERSION, DO NOT REMOVE
"a" = (
/obj/structure/chair/stool,
/turf/open/floor/wood,
/area/indoors/town)
"c" = (
/turf/closed/wall/mineral/wood,
/area/indoors/town)
"d" = (
/obj/effect/decal/cleanable/dirt/dust,
/turf/open/floor/wood,
/area/indoors/town)
"e" = (
/obj/structure/curtain/bounty{
	color = "grey"
	},
/obj/structure/window/openclose{
	dir = 4
	},
/turf/open/floor/ruinedwood/two,
/area/indoors/town)
"g" = (
/obj/structure/sign/property_sign/claim,
/turf/closed/wall/mineral/wood,
/area/indoors/town)
"l" = (
/obj/structure/ladder,
/turf/open/floor/wood,
/area/indoors/town)
"o" = (
/obj/structure/closet/crate/crafted_closet,
/obj/item/natural/cloth,
/obj/item/natural/cloth,
/obj/item/coin/copper/pile,
/obj/item/candle/yellow,
/obj/item/broom,
/obj/item/reagent_containers/glass/bucket/pot{
	pixel_y = 4
	},
/obj/item/key/houses/house4,
/turf/open/floor/wood,
/area/indoors/town)
"p" = (
/turf/closed/wall/mineral/wooddark,
/area/indoors/town)
"s" = (
/obj/structure/window/openclose{
	dir = 1
	},
/obj/structure/curtain/bounty{
	color = "grey"
	},
/turf/open/floor/ruinedwood/two,
/area/indoors/town)
"t" = (
/obj/structure/rack/shelf/biggest,
/obj/item/reagent_containers/glass/carafe,
/obj/item/storage/sack,
/obj/item/reagent_containers/glass/bucket/pot{
	pixel_y = 4
	},
/turf/open/floor/blocks/stonered/tiny,
/area/indoors/town)
"u" = (
/obj/machinery/light/fueled/hearth,
/obj/item/cooking/pan,
/turf/open/floor/cobble,
/area/indoors/town)
"v" = (
/obj/structure/closet/crate/chest/crafted,
/obj/effect/decal/cleanable/dirt/dust,
/turf/open/floor/wood,
/area/indoors/town)
"w" = (
/obj/effect/decal/cobbleedge{
	dir = 10;
	pixel_y = 1
	},
/obj/structure/closet/crate/chest/crafted,
/turf/open/floor/twig,
/area/indoors/town)
"E" = (
/obj/effect/decal/cobbleedge{
	dir = 10;
	pixel_y = 1
	},
/obj/structure/chair/stool,
/turf/open/floor/twig,
/area/indoors/town)
"I" = (
/obj/structure/bed/mediocre,
/obj/item/bedsheet/wool,
/obj/machinery/light/fueled/wallfire/candle,
/turf/open/floor/wood,
/area/indoors/town)
"K" = (
/turf/open/floor/twig,
/area/indoors/town)
"L" = (
/obj/structure/ladder,
/turf/open/floor/twig,
/area/indoors/town)
"M" = (
/obj/effect/decal/cobbleedge{
	dir = 10;
	icon_state = "cobbleedge-n"
	},
/turf/closed/wall/mineral/wood,
/area/indoors/town)
"P" = (
/obj/structure/table/wood{
	dir = 1;
	icon_state = "tablewood1"
	},
/obj/item/candle/yellow,
/obj/machinery/light/fueled/wallfire/candle/l,
/turf/open/floor/twig,
/area/indoors/town)
"R" = (
/obj/structure/door{
	lockid = "house4";
	name = "House IV"
	},
/turf/open/floor/twig,
/area/indoors/town)
"U" = (
/obj/structure/closet/crate/drawer,
/obj/item/coin/copper/pile,
/turf/open/floor/wood,
/area/indoors/town)
"W" = (
/obj/structure/window/openclose,
/obj/structure/curtain/bounty{
	color = "grey"
	},
/turf/open/floor/ruinedwood/two,
/area/indoors/town)
"X" = (
/obj/structure/curtain/bounty{
	color = "grey"
	},
/obj/structure/window/openclose{
	dir = 8
	},
/turf/open/floor/ruinedwood/two,
/area/indoors/town)

(1,1,1) = {"
p
c
c
c
p
"}
(2,1,1) = {"
c
t
P
L
c
"}
(3,1,1) = {"
c
E
K
K
g
"}
(4,1,1) = {"
c
u
w
K
R
"}
(5,1,1) = {"
p
c
M
c
p
"}

(1,1,2) = {"
p
p
e
p
p
"}
(2,1,2) = {"
p
I
d
l
s
"}
(3,1,2) = {"
W
d
d
v
s
"}
(4,1,2) = {"
W
U
a
o
s
"}
(5,1,2) = {"
p
p
X
p
p
"}
