//MAP CONVERTED BY dmm2tgm.py THIS HEADER COMMENT PREVENTS RECONVERSION, DO NOT REMOVE
"a" = (
/obj/structure/fluff/walldeco/vinez,
/turf/open/floor/naturalstone,
/area/under/cavewet)
"e" = (
/obj/item/natural/rock,
/obj/structure/fluff/walldeco/vinez,
/turf/open/floor/naturalstone,
/area/under/cavewet)
"f" = (
/obj/structure/flora/rock,
/obj/structure/fluff/walldeco/vinez,
/turf/open/floor/naturalstone,
/area/under/cavewet)
"h" = (
/obj/structure/flora/grass/water/reeds,
/turf/open/water/clean,
/area/under/cavewet)
"i" = (
/turf/open/floor/volcanic,
/area/under/cavewet)
"j" = (
/obj/item/natural/rock/random_ore,
/obj/structure/fluff/walldeco/vinez,
/turf/open/water/clean,
/area/under/cavewet)
"m" = (
/obj/structure/flora/grass/water,
/turf/open/water/clean,
/area/under/cavewet)
"y" = (
/obj/structure/flora/rock,
/turf/open/floor/naturalstone,
/area/under/cavewet)
"z" = (
/turf/open/floor/naturalstone,
/area/under/cavewet)
"B" = (
/obj/structure/fluff/walldeco/vinez,
/turf/open/water/clean,
/area/under/cavewet)
"D" = (
/obj/item/natural/rock/random_ore,
/turf/open/water/clean,
/area/under/cavewet)
"F" = (
/turf/open/water/clean,
/area/under/cavewet)
"H" = (
/turf/closed/mineral,
/area/under/cavewet)
"I" = (
/obj/structure/flora/grass/swampweed,
/turf/open/floor/naturalstone,
/area/under/cavewet)
"L" = (
/obj/structure/flora/grass/herb/random,
/turf/open/floor/naturalstone,
/area/under/cavewet)
"O" = (
/obj/structure/fluff/walldeco/vinez,
/turf/open/floor/volcanic,
/area/under/cavewet)
"P" = (
/obj/item/natural/rock,
/turf/open/water/clean,
/area/under/cavewet)
"R" = (
/mob/living/simple_animal/pet/cat/cabbit{
	name = "cabbit emptypool"
	},
/turf/open/floor/naturalstone,
/area/under/cavewet)
"S" = (
/obj/item/natural/rock/random_ore,
/turf/open/floor/naturalstone,
/area/under/cavewet)
"V" = (
/obj/item/natural/rock,
/turf/open/floor/naturalstone,
/area/under/cavewet)

(1,1,1) = {"
H
H
H
H
H
H
H
H
H
H
H
z
z
z
z
H
H
H
H
H
H
H
H
H
H
"}
(2,1,1) = {"
H
H
F
F
H
H
H
H
H
H
z
z
z
z
z
H
H
H
H
H
H
H
H
H
H
"}
(3,1,1) = {"
H
m
F
F
m
H
H
H
H
z
z
y
z
z
z
z
a
H
H
H
H
H
F
H
H
"}
(4,1,1) = {"
H
F
h
h
F
F
H
H
H
F
z
z
z
z
z
z
z
H
H
H
H
h
h
F
H
"}
(5,1,1) = {"
H
F
h
h
F
F
H
H
a
F
F
z
z
I
S
z
z
z
z
H
H
h
h
m
H
"}
(6,1,1) = {"
H
F
h
F
F
H
H
H
a
F
z
a
a
a
z
H
z
V
z
a
H
F
h
F
H
"}
(7,1,1) = {"
H
H
H
H
H
H
H
H
z
z
z
a
B
B
F
H
H
z
z
z
H
H
H
H
H
"}
(8,1,1) = {"
H
H
H
H
H
H
H
z
z
z
z
D
F
F
H
H
H
z
z
z
H
H
H
H
H
"}
(9,1,1) = {"
H
H
H
H
a
a
z
a
a
z
F
F
h
F
F
F
F
F
f
z
z
z
H
H
H
"}
(10,1,1) = {"
H
z
z
z
z
z
z
a
j
F
F
F
F
F
F
m
F
F
z
z
z
a
H
H
H
"}
(11,1,1) = {"
z
z
z
V
F
F
L
z
F
F
F
F
B
B
F
F
h
F
F
z
z
a
z
z
H
"}
(12,1,1) = {"
z
z
z
z
F
F
z
z
F
h
F
F
F
F
F
F
H
H
z
I
S
a
z
z
z
"}
(13,1,1) = {"
z
z
z
F
z
z
I
z
z
H
H
F
F
F
F
H
H
z
z
z
z
z
e
a
z
"}
(14,1,1) = {"
z
z
z
z
z
y
z
z
H
H
H
F
m
F
F
F
z
L
z
z
z
z
z
z
z
"}
(15,1,1) = {"
H
H
H
H
H
a
F
i
H
H
z
F
z
F
P
z
z
z
S
z
z
z
z
z
H
"}
(16,1,1) = {"
H
H
H
H
H
H
B
F
F
z
z
z
z
z
z
H
z
z
z
z
H
z
z
H
H
"}
(17,1,1) = {"
H
H
H
H
H
H
O
F
F
F
z
L
S
z
H
H
H
z
z
z
H
H
H
H
H
"}
(18,1,1) = {"
H
H
H
H
H
H
B
F
i
i
z
z
z
z
H
H
H
z
z
a
H
H
H
H
H
"}
(19,1,1) = {"
H
H
H
H
H
H
H
O
i
z
z
z
z
z
z
z
z
z
a
H
H
H
H
H
H
"}
(20,1,1) = {"
H
H
F
H
H
H
H
H
H
H
H
z
z
z
z
z
z
a
H
H
H
H
H
H
H
"}
(21,1,1) = {"
H
m
F
h
H
H
H
H
R
H
H
a
z
V
z
z
H
H
H
H
H
h
F
H
H
"}
(22,1,1) = {"
H
F
h
F
H
H
H
H
H
H
H
a
z
z
z
z
H
H
H
H
h
h
m
H
H
"}
(23,1,1) = {"
H
F
h
F
H
F
H
H
H
H
H
a
z
z
z
H
H
H
H
H
F
F
F
H
H
"}
(24,1,1) = {"
H
F
F
m
H
H
H
H
H
H
H
H
z
z
z
H
H
H
H
H
H
H
H
H
H
"}
(25,1,1) = {"
H
H
H
H
H
H
H
H
H
H
H
H
z
z
z
H
H
H
H
H
H
H
H
H
H
"}
