//MAP CONVERTED BY dmm2tgm.py THIS HEADER COMMENT PREVENTS RECONVERSION, DO NOT REMOVE
"a" = (
/turf/open/floor/grass/yel,
/area/under/cave)
"b" = (
/obj/effect/spawner/map_spawner/necropolis,
/turf/open/floor/grass/yel,
/area/under/cave)
"c" = (
/turf/closed/mineral/random/low_nonval,
/area/under/cave)
"j" = (
/turf/closed/mineral/silver,
/area/under/cave)
"k" = (
/obj/effect/landmark/map_load_mark/necropolis/z3_pillars,
/turf/open/floor/naturalstone,
/area/under/cave)
"m" = (
/turf/open/floor/naturalstone,
/area/under/cave)
"q" = (
/obj/effect/spawner/map_spawner/necropolis/mob_spawner/goblin,
/turf/open/floor/grass/yel,
/area/under/cave)
"v" = (
/turf/closed/mineral/random,
/area/under/cave)
"x" = (
/turf/closed/mineral/random/high_valuable,
/area/under/cave)
"y" = (
/obj/effect/landmark/map_load_mark/necropolis/z3_pillars,
/turf/closed/mineral,
/area/under/cave)
"B" = (
/obj/structure/fluff/signage{
	desc = "Take the bounty of the earth at your own risk!";
	name = "A warning"
	},
/turf/open/floor/naturalstone,
/area/under/cave)
"C" = (
/turf/closed/mineral,
/area/under/cave)
"E" = (
/obj/effect/spawner/map_spawner/necropolis/water_tiles,
/turf/open/floor/grass/yel,
/area/under/cave)
"J" = (
/obj/effect/spawner/map_spawner/necropolis,
/turf/open/floor/naturalstone,
/area/under/cave)
"L" = (
/turf/closed/mineral/copper,
/area/under/cave)
"M" = (
/obj/effect/spawner/map_spawner/necropolis/shroom_clutter,
/turf/open/floor/naturalstone,
/area/under/cave)
"N" = (
/turf/closed/mineral/gold,
/area/under/cave)
"T" = (
/obj/effect/spawner/map_spawner/necropolis/random_rock_wall,
/turf/open/floor/naturalstone,
/area/under/cave)
"X" = (
/obj/effect/spawner/map_spawner/necropolis/random_rock_wall,
/turf/open/floor/grass/yel,
/area/under/cave)
"Y" = (
/obj/effect/spawner/map_spawner/necropolis/water_tiles,
/turf/open/floor/naturalstone,
/area/under/cave)

(1,1,1) = {"
C
C
C
C
C
C
C
C
C
m
M
C
C
C
C
C
C
C
C
C
C
C
C
C
C
"}
(2,1,1) = {"
C
C
C
C
C
C
C
C
C
B
m
C
C
C
C
C
C
C
C
C
C
c
c
C
C
"}
(3,1,1) = {"
C
c
c
c
C
c
c
C
C
m
m
C
C
C
q
m
m
C
C
c
c
c
c
C
C
"}
(4,1,1) = {"
C
c
c
c
C
C
C
C
a
a
E
C
C
C
b
a
M
C
c
c
c
c
c
C
C
"}
(5,1,1) = {"
C
c
c
c
c
c
C
C
a
b
E
a
C
C
X
a
a
C
c
c
c
c
c
C
C
"}
(6,1,1) = {"
C
C
c
C
c
c
C
C
a
a
C
X
N
C
a
a
b
C
C
c
c
c
c
C
C
"}
(7,1,1) = {"
C
c
c
c
c
c
C
C
C
C
L
a
m
Y
Y
m
X
T
C
C
C
v
v
v
C
"}
(8,1,1) = {"
C
c
c
c
c
c
y
C
C
C
L
m
m
Y
Y
a
X
T
m
k
C
v
v
v
x
"}
(9,1,1) = {"
C
C
C
C
C
C
C
C
C
L
L
m
Y
N
N
C
C
C
a
a
C
v
v
v
C
"}
(10,1,1) = {"
C
C
C
C
a
a
b
a
m
Y
Y
Y
Y
C
C
C
C
C
a
a
j
v
v
v
C
"}
(11,1,1) = {"
C
c
c
C
a
a
a
a
m
M
m
a
Y
C
C
C
a
b
a
m
C
j
j
j
C
"}
(12,1,1) = {"
M
C
c
C
C
a
C
C
a
C
C
a
a
C
C
C
C
X
X
m
a
C
j
j
C
"}
(13,1,1) = {"
m
C
C
C
C
a
C
C
q
a
a
a
b
a
k
m
C
C
X
J
a
C
j
j
C
"}
(14,1,1) = {"
m
m
m
B
C
a
a
c
c
c
C
b
a
M
m
m
C
C
X
T
C
C
c
C
C
"}
(15,1,1) = {"
m
m
m
m
T
T
m
m
T
X
X
a
m
C
C
C
C
a
X
T
C
C
c
C
C
"}
(16,1,1) = {"
m
C
M
C
C
C
a
M
T
T
X
a
Y
Y
Y
C
C
a
a
M
C
C
c
c
C
"}
(17,1,1) = {"
C
C
C
C
C
C
a
m
C
C
C
a
q
C
Y
C
c
a
a
a
C
C
c
c
C
"}
(18,1,1) = {"
C
C
C
C
C
C
a
a
m
m
C
C
C
C
Y
C
c
a
b
a
C
C
C
C
C
"}
(19,1,1) = {"
C
C
C
C
C
C
m
m
C
m
C
m
m
C
C
C
C
a
a
m
T
a
m
C
C
"}
(20,1,1) = {"
C
c
c
C
C
C
J
m
y
m
C
m
m
C
c
C
C
a
a
m
X
a
k
C
C
"}
(21,1,1) = {"
C
c
c
c
C
C
m
m
T
T
T
m
M
a
a
a
a
a
a
C
X
a
m
C
C
"}
(22,1,1) = {"
C
c
c
c
C
C
M
m
m
T
T
m
J
m
a
a
b
a
q
C
X
a
m
C
C
"}
(23,1,1) = {"
C
c
c
c
C
C
m
m
C
C
C
T
C
C
C
a
a
a
C
C
X
a
J
C
C
"}
(24,1,1) = {"
C
C
C
c
c
C
C
C
C
C
C
T
C
C
C
a
b
a
C
C
C
C
C
C
C
"}
(25,1,1) = {"
C
C
C
C
C
C
C
C
C
m
m
m
m
m
C
C
C
C
C
C
c
c
c
C
C
"}
