//MAP CONVERTED BY dmm2tgm.py THIS HEADER COMMENT PREVENTS RECONVERSION, DO NOT REMOVE
"a" = (
/turf/closed/mineral,
/area/under/cave)
"b" = (
/obj/effect/spawner/map_spawner/necropolis/water_tiles,
/turf/open/floor/naturalstone,
/area/under/cave)
"e" = (
/obj/effect/spawner/map_spawner/necropolis/shroom_clutter,
/turf/open/floor/naturalstone,
/area/under/cave)
"g" = (
/obj/effect/spawner/map_spawner/necropolis/random_dirty,
/obj/effect/spawner/map_spawner/necropolis/water_tiles,
/turf/open/floor/naturalstone,
/area/under/cave)
"l" = (
/obj/effect/landmark/map_load_mark/necropolis/z3_pillars,
/turf/open/floor/volcanic,
/area/under/cave)
"n" = (
/obj/effect/spawner/map_spawner/necropolis/random_rock_wall,
/turf/open/floor/naturalstone,
/area/under/cave)
"o" = (
/obj/effect/spawner/map_spawner/necropolis/random_dirty,
/obj/effect/spawner/map_spawner/necropolis/water_tiles,
/turf/open/floor/volcanic,
/area/under/cave)
"p" = (
/turf/open/floor/grass/hell,
/area/under/cave)
"q" = (
/obj/effect/spawner/map_spawner/necropolis/water_tiles,
/turf/open/floor/volcanic,
/area/under/cave)
"r" = (
/obj/effect/spawner/map_spawner/necropolis/random_dirty,
/obj/effect/spawner/map_spawner/necropolis,
/turf/open/floor/volcanic,
/area/under/cave)
"x" = (
/obj/effect/spawner/map_spawner/necropolis/random_dirty,
/turf/open/floor/naturalstone,
/area/under/cave)
"A" = (
/obj/effect/spawner/map_spawner/necropolis/shroom_clutter,
/turf/open/floor/volcanic,
/area/under/cave)
"B" = (
/obj/effect/spawner/map_spawner/necropolis/mob_spawner,
/turf/open/floor/volcanic,
/area/under/cave)
"C" = (
/obj/effect/landmark/map_load_mark/necropolis/z3_pillars,
/turf/open/floor/naturalstone,
/area/under/cave)
"G" = (
/obj/effect/landmark/map_load_mark/necropolis/z3_pillars,
/turf/closed/mineral,
/area/under/cave)
"J" = (
/turf/open/floor/volcanic,
/area/under/cave)
"K" = (
/obj/effect/spawner/map_spawner/necropolis/mob_spawner/easy,
/turf/open/floor/naturalstone,
/area/under/cave)
"M" = (
/obj/effect/spawner/map_spawner/necropolis,
/turf/open/floor/naturalstone,
/area/under/cave)
"N" = (
/obj/effect/spawner/map_spawner/necropolis,
/turf/open/floor/volcanic,
/area/under/cave)
"O" = (
/obj/effect/spawner/map_spawner/necropolis/random_dirty,
/turf/open/floor/volcanic,
/area/under/cave)
"R" = (
/turf/open/floor/naturalstone,
/area/under/cave)
"X" = (
/obj/effect/spawner/map_spawner/necropolis/random_rock_wall,
/turf/open/floor/volcanic,
/area/under/cave)

(1,1,1) = {"
a
a
a
a
a
a
R
R
a
a
a
a
R
n
a
a
a
a
R
C
a
a
a
a
a
"}
(2,1,1) = {"
a
a
R
R
a
a
a
R
a
R
R
a
R
R
a
a
a
a
R
R
a
a
a
a
a
"}
(3,1,1) = {"
a
a
R
K
a
a
a
R
a
J
R
R
b
b
a
a
a
a
R
R
a
a
R
a
a
"}
(4,1,1) = {"
a
a
R
R
G
a
a
R
a
R
a
a
b
b
a
a
R
J
N
J
e
b
b
R
a
"}
(5,1,1) = {"
a
a
O
x
R
a
R
M
J
J
J
a
b
b
e
R
g
x
J
J
R
b
b
R
a
"}
(6,1,1) = {"
a
a
O
x
R
a
R
n
J
R
a
a
R
R
J
J
g
x
a
a
a
R
R
a
a
"}
(7,1,1) = {"
a
J
N
R
R
R
R
R
J
R
a
a
a
a
a
a
J
R
a
a
a
R
R
a
a
"}
(8,1,1) = {"
a
J
J
a
R
a
R
J
e
b
b
q
J
J
a
a
J
e
a
J
R
R
R
R
a
"}
(9,1,1) = {"
a
J
J
a
R
a
b
q
R
b
q
q
e
n
R
J
M
R
a
a
J
M
R
R
a
"}
(10,1,1) = {"
a
a
a
a
R
a
a
q
a
a
a
a
J
R
R
R
R
R
a
a
a
R
C
R
a
"}
(11,1,1) = {"
a
a
a
a
a
a
a
J
a
a
a
a
J
J
a
a
R
a
a
a
a
R
R
a
a
"}
(12,1,1) = {"
b
b
R
a
a
a
J
X
x
O
J
J
J
J
R
R
R
R
R
a
a
R
R
R
a
"}
(13,1,1) = {"
b
b
g
o
q
J
J
R
x
O
J
R
C
a
a
R
a
R
K
a
a
J
q
b
R
"}
(14,1,1) = {"
R
J
O
x
e
R
J
J
J
a
a
J
R
R
R
R
a
R
R
a
J
J
q
b
R
"}
(15,1,1) = {"
a
A
a
a
a
a
a
a
p
p
a
J
R
R
a
a
a
a
R
a
a
J
q
J
R
"}
(16,1,1) = {"
a
J
a
J
B
J
a
a
J
p
J
R
M
q
q
q
q
J
R
R
a
a
q
R
a
"}
(17,1,1) = {"
a
J
J
J
R
l
a
a
J
J
J
J
q
q
q
q
q
R
R
e
a
a
b
a
a
"}
(18,1,1) = {"
a
J
a
a
a
a
a
a
J
J
a
a
J
J
R
a
a
a
a
R
a
a
b
a
a
"}
(19,1,1) = {"
a
J
a
p
J
J
p
p
p
a
a
a
J
a
a
a
a
a
a
R
a
J
R
a
a
"}
(20,1,1) = {"
a
R
a
p
p
R
p
J
J
a
a
a
J
J
R
J
J
l
R
J
R
R
R
a
a
"}
(21,1,1) = {"
a
R
a
a
p
R
p
a
a
a
a
a
J
J
A
J
J
J
R
J
a
a
R
R
a
"}
(22,1,1) = {"
R
R
N
J
p
N
R
J
J
a
J
a
a
e
J
a
a
a
R
a
a
a
R
n
a
"}
(23,1,1) = {"
R
J
J
J
J
A
R
J
J
J
J
X
R
x
x
J
a
a
J
R
J
M
R
R
a
"}
(24,1,1) = {"
a
R
a
a
q
q
q
a
a
J
J
J
R
x
r
J
a
a
J
J
J
J
J
R
a
"}
(25,1,1) = {"
a
a
a
a
b
b
b
a
a
a
a
a
a
J
O
a
a
a
a
a
R
R
a
a
a
"}
