//MAP CONVERTED BY dmm2tgm.py THIS HEADER COMMENT PREVENTS RECONVERSION, DO NOT REMOVE
"a" = (
/turf/open/floor/dirt,
/area/under/cave)
"b" = (
/obj/effect/spawner/map_spawner/necropolis/water_tiles,
/turf/open/floor/naturalstone,
/area/under/cave)
"e" = (
/obj/effect/spawner/map_spawner/loot/weapon,
/turf/open/floor/naturalstone,
/area/under/cave)
"r" = (
/obj/effect/spawner/map_spawner/necropolis/random_dirty,
/turf/open/floor/naturalstone,
/area/under/cave)
"w" = (
/obj/effect/spawner/map_spawner/loot/potion_ingredient/herb,
/turf/open/floor/naturalstone,
/area/under/cave)
"B" = (
/turf/open/floor/naturalstone,
/area/under/cave)
"C" = (
/obj/effect/landmark/map_load_mark/necropolis/z3_pillars,
/turf/closed/mineral,
/area/under/cave)
"J" = (
/obj/effect/spawner/map_spawner/necropolis/random_rock_wall,
/turf/open/floor/naturalstone,
/area/under/cave)
"M" = (
/obj/effect/spawner/map_spawner/necropolis,
/turf/open/floor/naturalstone,
/area/under/cave)
"N" = (
/obj/effect/spawner/map_spawner/loot/common,
/turf/open/floor/naturalstone,
/area/under/cave)
"P" = (
/turf/closed/mineral,
/area/under/cave)
"R" = (
/obj/effect/landmark/map_load_mark/necropolis/z3_pillars,
/turf/open/floor/dirt,
/area/under/cave)
"U" = (
/obj/effect/spawner/map_spawner/necropolis/shroom_clutter,
/turf/open/floor/dirt,
/area/under/cave)
"W" = (
/obj/effect/spawner/map_spawner/necropolis/shroom_clutter,
/turf/open/floor/naturalstone,
/area/under/cave)
"Y" = (
/obj/effect/spawner/map_spawner/loot/armor,
/turf/open/floor/naturalstone,
/area/under/cave)

(1,1,1) = {"
P
P
P
P
P
P
P
P
P
B
B
P
P
C
P
P
P
P
P
P
P
P
P
P
P
"}
(2,1,1) = {"
P
b
B
B
B
B
B
B
r
r
r
M
B
B
b
b
b
b
B
B
B
M
B
P
P
"}
(3,1,1) = {"
P
b
B
P
B
B
W
B
r
r
r
B
B
B
b
b
b
b
B
b
B
B
r
B
P
"}
(4,1,1) = {"
P
b
B
P
P
P
P
P
P
P
a
P
P
P
P
P
P
P
P
P
P
P
r
B
P
"}
(5,1,1) = {"
P
b
B
C
P
P
P
P
P
P
B
P
P
B
B
B
w
P
P
P
P
P
B
B
C
"}
(6,1,1) = {"
P
b
B
B
B
B
B
W
B
B
B
B
B
B
B
B
B
P
P
P
P
P
B
r
P
"}
(7,1,1) = {"
P
b
B
P
B
P
B
P
P
P
P
P
P
P
P
a
B
B
W
B
P
P
B
r
P
"}
(8,1,1) = {"
P
B
B
P
B
B
J
P
P
P
P
P
a
P
P
U
B
r
r
w
P
P
B
B
P
"}
(9,1,1) = {"
P
B
B
P
P
B
B
P
P
P
B
B
a
a
P
U
a
B
B
B
P
P
B
b
P
"}
(10,1,1) = {"
B
W
B
P
P
B
B
Y
P
P
M
P
a
P
C
P
a
P
P
B
P
B
B
b
P
"}
(11,1,1) = {"
B
B
B
P
P
P
P
P
P
P
B
P
P
P
P
B
a
a
B
B
B
B
b
b
P
"}
(12,1,1) = {"
J
B
B
P
P
P
P
P
P
B
W
B
a
a
W
B
B
P
P
B
P
P
b
b
P
"}
(13,1,1) = {"
B
B
B
P
C
P
P
P
P
B
B
B
B
B
B
B
B
P
B
B
P
P
b
b
P
"}
(14,1,1) = {"
B
B
B
P
P
a
P
a
P
R
B
P
P
P
B
P
P
P
B
B
P
P
B
B
P
"}
(15,1,1) = {"
P
B
P
P
P
N
B
B
B
a
a
B
P
P
B
B
P
P
B
P
P
P
B
B
P
"}
(16,1,1) = {"
P
B
P
P
P
B
B
P
P
P
B
P
P
P
a
a
B
J
M
B
a
P
r
B
P
"}
(17,1,1) = {"
P
B
B
P
P
B
P
P
P
P
B
P
P
P
e
a
B
B
B
W
a
P
r
M
C
"}
(18,1,1) = {"
P
b
B
P
P
B
P
P
P
P
W
B
B
B
B
B
P
W
W
B
P
P
r
B
P
"}
(19,1,1) = {"
P
b
B
P
P
B
P
P
P
B
B
B
P
P
P
P
P
W
W
a
P
P
B
B
P
"}
(20,1,1) = {"
P
b
B
P
P
W
B
B
B
B
P
P
P
B
M
B
B
B
U
a
P
P
W
B
P
"}
(21,1,1) = {"
P
b
B
P
P
P
a
a
P
B
P
P
B
B
B
N
B
P
P
P
P
P
M
B
P
"}
(22,1,1) = {"
P
b
b
P
P
P
P
P
P
a
a
P
P
P
P
C
P
P
P
P
P
P
B
B
P
"}
(23,1,1) = {"
P
B
b
b
B
P
P
P
B
B
B
B
b
b
b
b
b
b
B
B
B
B
r
B
P
"}
(24,1,1) = {"
P
B
b
b
B
B
B
B
B
B
B
B
B
B
b
b
b
b
B
B
P
B
r
P
P
"}
(25,1,1) = {"
P
P
P
P
P
P
P
P
P
P
P
B
B
J
P
P
P
P
P
P
P
P
P
P
P
"}
