//MAP CONVERTED BY dmm2tgm.py THIS HEADER COMMENT PREVENTS RECONVERSION, DO NOT REMOVE
"a" = (
/turf/closed/mineral,
/area/under/cave)
"c" = (
/obj/effect/spawner/map_spawner/necropolis/water_tiles,
/turf/open/floor/naturalstone,
/area/under/cave)
"j" = (
/obj/effect/spawner/map_spawner/necropolis/shroom_clutter,
/turf/open/floor/dirt,
/area/under/cave)
"l" = (
/obj/effect/landmark/map_load_mark/necropolis/z3_pillars,
/turf/open/floor/naturalstone,
/area/under/cave)
"r" = (
/obj/effect/spawner/map_spawner/necropolis/mob_spawner,
/turf/open/floor/naturalstone,
/area/under/cave)
"t" = (
/turf/open/floor/dirt,
/area/under/cave)
"C" = (
/obj/effect/landmark/map_load_mark/necropolis/z3_pillars,
/turf/open/floor/dirt,
/area/under/cave)
"D" = (
/obj/effect/spawner/map_spawner/necropolis/water_tiles,
/turf/open/floor/dirt,
/area/under/cave)
"H" = (
/obj/effect/spawner/map_spawner/necropolis/shroom_clutter,
/turf/open/floor/naturalstone,
/area/under/cave)
"K" = (
/turf/open/floor/naturalstone,
/area/under/cave)
"L" = (
/obj/effect/spawner/map_spawner/necropolis/mob_spawner/easy,
/turf/open/floor/naturalstone,
/area/under/cave)
"T" = (
/obj/effect/spawner/map_spawner/necropolis/random_rock_wall,
/turf/open/floor/naturalstone,
/area/under/cave)
"V" = (
/obj/effect/spawner/map_spawner/necropolis/mob_spawner/easy,
/turf/open/floor/dirt,
/area/under/cave)

(1,1,1) = {"
a
a
a
a
a
a
a
a
a
a
a
a
K
K
K
K
K
K
a
a
a
a
a
a
a
"}
(2,1,1) = {"
a
a
a
a
a
a
a
a
a
a
a
a
H
K
T
K
K
K
a
a
a
a
a
a
a
"}
(3,1,1) = {"
a
a
a
K
l
K
K
K
K
K
K
K
K
c
T
T
l
c
c
c
c
K
K
a
a
"}
(4,1,1) = {"
a
a
a
K
a
a
K
a
a
K
a
a
K
c
K
T
K
K
K
K
K
K
K
a
a
"}
(5,1,1) = {"
a
a
a
K
a
a
r
K
K
K
a
a
t
t
c
K
K
K
a
a
a
r
a
a
a
"}
(6,1,1) = {"
a
a
a
K
a
a
a
a
a
a
a
a
t
t
t
a
a
a
a
a
a
K
a
a
a
"}
(7,1,1) = {"
a
a
K
K
a
a
a
a
a
a
a
a
t
j
K
a
a
a
a
a
a
K
a
a
a
"}
(8,1,1) = {"
a
a
T
a
a
a
K
j
t
t
L
t
t
t
K
c
K
K
K
K
K
K
K
a
a
"}
(9,1,1) = {"
a
a
K
a
a
a
K
t
j
t
t
t
D
D
D
c
K
H
K
c
c
c
K
a
a
"}
(10,1,1) = {"
a
a
H
a
a
T
T
K
t
t
j
t
D
D
c
K
H
H
K
c
c
D
K
a
a
"}
(11,1,1) = {"
K
a
H
K
a
T
T
a
a
a
a
a
a
t
a
a
H
K
a
a
a
t
K
a
a
"}
(12,1,1) = {"
K
a
K
K
a
K
a
a
a
a
a
a
a
a
a
a
t
K
a
a
a
K
K
a
a
"}
(13,1,1) = {"
K
T
c
c
c
D
t
t
K
K
a
a
a
a
a
a
t
K
a
a
a
K
K
l
K
"}
(14,1,1) = {"
K
T
c
K
H
K
t
t
C
t
a
a
a
a
a
a
K
K
a
a
a
K
K
K
K
"}
(15,1,1) = {"
K
c
K
H
H
H
t
t
K
t
a
a
a
a
a
a
t
t
K
K
K
K
T
T
K
"}
(16,1,1) = {"
K
a
a
K
a
a
t
t
K
a
a
a
a
K
K
a
t
t
t
K
T
T
T
K
K
"}
(17,1,1) = {"
K
a
a
T
a
a
t
K
K
c
c
c
c
K
K
a
t
V
t
a
a
K
K
K
K
"}
(18,1,1) = {"
a
a
a
T
a
a
t
t
K
K
K
K
K
K
K
a
a
t
a
a
a
K
a
a
K
"}
(19,1,1) = {"
a
a
a
K
a
a
V
t
c
a
a
a
a
K
l
a
a
a
a
a
a
c
a
a
a
"}
(20,1,1) = {"
a
a
a
H
a
a
K
D
t
a
a
a
a
T
K
a
a
a
a
a
a
c
a
a
a
"}
(21,1,1) = {"
a
a
a
H
a
a
K
c
K
a
a
a
a
T
T
K
D
D
t
t
K
c
a
a
a
"}
(22,1,1) = {"
a
a
a
K
a
a
a
a
a
a
a
a
a
H
T
K
c
D
D
D
K
K
a
a
a
"}
(23,1,1) = {"
a
K
K
K
a
a
a
a
a
a
a
a
a
H
H
a
a
a
a
a
a
K
a
a
a
"}
(24,1,1) = {"
a
H
a
a
a
a
a
a
a
a
a
a
a
K
H
a
a
a
a
a
a
a
a
a
a
"}
(25,1,1) = {"
a
K
K
K
K
K
K
K
K
K
K
K
K
K
K
K
K
a
a
a
a
a
a
a
a
"}
