//MAP CONVERTED BY dmm2tgm.py THIS HEADER COMMENT PREVENTS RECONVERSION, DO NOT REMOVE
"a" = (
/turf/closed/mineral,
/area/indoors/cave)
"q" = (
/turf/open/openspace,
/area/indoors/cave)
"y" = (
/turf/open/floor/naturalstone,
/area/indoors/cave)

(1,1,1) = {"
a
a
a
a
a
a
a
a
a
a
a
a
a
y
y
y
y
a
a
a
a
a
a
a
a
"}
(2,1,1) = {"
a
a
a
a
a
a
a
a
a
a
a
y
y
y
a
y
a
a
a
a
a
a
a
a
a
"}
(3,1,1) = {"
a
a
a
a
a
a
a
y
y
y
a
y
a
a
a
y
a
y
y
y
a
a
q
q
a
"}
(4,1,1) = {"
a
a
q
y
a
a
a
y
a
y
a
a
y
a
a
y
y
y
a
y
y
a
y
q
a
"}
(5,1,1) = {"
a
a
a
y
a
a
a
y
a
y
a
a
y
y
a
a
a
a
a
a
y
y
y
a
a
"}
(6,1,1) = {"
a
a
a
y
y
y
a
y
a
y
y
a
a
y
a
a
a
a
a
a
a
a
a
a
a
"}
(7,1,1) = {"
a
a
a
a
a
y
y
y
a
a
a
y
y
y
y
y
y
a
a
a
a
a
a
a
a
"}
(8,1,1) = {"
a
a
a
a
a
y
a
a
a
a
y
y
a
a
a
a
y
y
y
y
y
y
a
y
a
"}
(9,1,1) = {"
a
a
a
a
a
y
a
a
a
a
y
a
a
a
a
a
a
a
a
a
a
y
y
y
a
"}
(10,1,1) = {"
a
a
a
a
y
y
y
a
a
a
y
a
a
a
a
a
a
a
a
a
y
y
a
a
a
"}
(11,1,1) = {"
y
a
a
y
y
a
y
y
y
y
y
a
a
a
a
a
a
a
a
a
y
a
a
a
a
"}
(12,1,1) = {"
y
y
y
y
a
a
y
y
a
a
y
a
a
a
y
y
y
y
a
a
y
y
y
a
a
"}
(13,1,1) = {"
y
a
a
a
a
a
y
a
a
a
y
y
a
a
y
a
a
y
y
a
a
a
y
a
y
"}
(14,1,1) = {"
y
a
a
a
a
a
y
a
a
a
y
a
a
a
y
a
a
a
y
a
a
a
y
y
y
"}
(15,1,1) = {"
y
a
a
a
a
a
y
a
a
a
y
y
a
a
y
y
a
a
y
a
a
a
a
a
y
"}
(16,1,1) = {"
y
a
y
y
q
y
y
a
a
y
y
y
y
y
y
y
a
a
y
a
a
a
a
a
y
"}
(17,1,1) = {"
a
a
y
a
a
a
a
a
a
y
a
a
a
a
a
a
a
a
y
a
a
a
y
y
y
"}
(18,1,1) = {"
a
a
y
a
a
a
a
a
a
y
y
y
y
a
a
a
a
y
y
a
a
a
y
y
a
"}
(19,1,1) = {"
a
a
a
y
a
a
a
a
a
a
a
a
y
a
a
y
y
y
a
a
a
y
y
y
a
"}
(20,1,1) = {"
a
a
a
y
a
a
a
a
a
y
y
y
y
y
y
y
a
a
a
a
y
y
a
a
a
"}
(21,1,1) = {"
a
a
a
y
y
a
a
a
a
y
a
a
a
a
a
y
a
a
a
a
y
a
a
a
a
"}
(22,1,1) = {"
a
a
a
a
y
y
y
y
a
y
y
a
a
a
a
y
a
a
a
y
y
a
a
a
a
"}
(23,1,1) = {"
a
a
a
a
q
y
a
y
y
y
y
y
y
y
a
y
y
y
y
y
a
a
a
a
a
"}
(24,1,1) = {"
a
a
a
a
a
a
a
y
a
a
a
a
a
y
a
y
a
a
a
a
a
a
a
a
a
"}
(25,1,1) = {"
a
a
a
a
a
y
y
y
a
a
a
y
y
y
y
y
a
a
a
a
a
a
a
a
a
"}
