//MAP CONVERTED BY dmm2tgm.py THIS HEADER COMMENT PREVENTS RECONVERSION, DO NOT REMOVE
"a" = (
/turf/open/openspace,
/area/indoors/cave)
"b" = (
/turf/open/floor/naturalstone,
/area/indoors/cave)
"e" = (
/obj/effect/spawner/map_spawner/loot/weapon,
/turf/open/floor/naturalstone,
/area/indoors/cave)
"w" = (
/obj/effect/spawner/map_spawner/loot/potion_ingredient/herb,
/turf/open/floor/naturalstone,
/area/indoors/cave)
"N" = (
/obj/effect/spawner/map_spawner/loot/common,
/turf/open/floor/naturalstone,
/area/indoors/cave)
"P" = (
/turf/closed/mineral,
/area/indoors/cave)
"Y" = (
/obj/effect/spawner/map_spawner/loot/armor,
/turf/open/floor/naturalstone,
/area/indoors/cave)

(1,1,1) = {"
P
P
P
P
P
P
P
P
P
P
P
P
P
P
P
P
P
P
P
P
P
P
P
P
P
"}
(2,1,1) = {"
P
b
b
b
b
b
b
b
b
b
b
b
b
b
b
b
b
b
b
b
b
b
b
b
P
"}
(3,1,1) = {"
P
b
b
b
b
b
b
b
b
b
b
b
b
b
b
b
b
b
b
b
b
b
b
b
P
"}
(4,1,1) = {"
P
b
b
P
P
P
P
P
P
P
a
P
P
P
P
P
P
P
P
P
P
P
b
b
P
"}
(5,1,1) = {"
P
b
b
P
P
P
P
P
P
P
b
P
P
b
b
b
w
P
P
P
P
P
b
b
P
"}
(6,1,1) = {"
P
b
b
b
b
b
b
b
b
b
b
b
b
b
b
b
b
P
P
P
P
P
b
b
P
"}
(7,1,1) = {"
P
b
b
P
b
P
b
P
P
P
P
P
P
P
P
a
b
b
b
b
P
P
b
b
P
"}
(8,1,1) = {"
P
b
b
P
b
b
b
P
P
P
P
P
a
P
P
a
b
b
b
w
P
P
b
b
P
"}
(9,1,1) = {"
P
b
b
P
P
b
b
P
P
P
b
b
a
a
P
a
a
b
b
b
P
P
b
b
P
"}
(10,1,1) = {"
P
b
b
P
P
b
b
Y
P
P
b
P
a
P
P
P
a
P
P
b
P
b
b
b
P
"}
(11,1,1) = {"
P
b
b
P
P
P
P
P
P
P
b
P
P
P
P
b
a
a
b
b
b
b
b
b
P
"}
(12,1,1) = {"
P
b
b
P
P
P
P
P
P
b
b
b
a
a
b
b
b
P
P
b
P
P
b
b
P
"}
(13,1,1) = {"
P
b
b
P
P
P
P
P
P
b
b
b
b
b
b
b
b
P
b
b
P
P
b
b
P
"}
(14,1,1) = {"
P
b
b
P
P
a
P
a
P
a
b
P
P
P
b
P
P
P
b
b
P
P
b
b
P
"}
(15,1,1) = {"
P
b
b
P
P
N
b
b
b
a
a
b
P
P
b
b
P
P
b
P
P
P
b
b
P
"}
(16,1,1) = {"
P
b
b
P
P
b
b
P
P
P
b
P
P
P
a
a
b
b
b
b
a
P
b
b
P
"}
(17,1,1) = {"
P
b
b
P
P
b
P
P
P
P
b
P
P
P
e
a
b
b
b
b
a
P
b
b
P
"}
(18,1,1) = {"
P
b
b
P
P
b
P
P
P
P
b
b
b
b
b
b
P
b
b
b
P
P
b
b
P
"}
(19,1,1) = {"
P
b
b
P
P
b
P
P
P
b
b
b
P
P
P
P
P
b
b
a
P
P
b
b
P
"}
(20,1,1) = {"
P
b
b
P
P
b
b
b
b
b
P
P
P
b
b
b
b
b
a
a
P
P
b
b
P
"}
(21,1,1) = {"
P
b
b
P
P
P
a
a
P
b
P
P
b
b
b
N
b
P
P
P
P
P
b
b
P
"}
(22,1,1) = {"
P
b
b
P
P
P
P
P
P
a
a
P
P
P
P
P
P
P
P
P
P
P
b
b
P
"}
(23,1,1) = {"
P
b
b
b
b
b
b
b
b
b
b
b
b
b
b
b
b
b
b
b
b
b
b
b
P
"}
(24,1,1) = {"
P
b
b
b
b
b
b
b
b
b
b
b
b
b
b
b
b
b
b
b
b
b
b
b
P
"}
(25,1,1) = {"
P
P
P
P
P
P
P
P
P
P
P
P
P
P
P
P
P
P
P
P
P
P
P
P
P
"}
