//MAP CONVERTED BY dmm2tgm.py THIS HEADER COMMENT PREVENTS RECONVERSION, DO NOT REMOVE
"a" = (
/turf/closed/mineral,
/area/under/cave)
"b" = (
/obj/effect/spawner/map_spawner/necropolis/random_rock_wall,
/turf/open/floor/dirt,
/area/under/cave)
"c" = (
/obj/effect/spawner/map_spawner/necropolis/mob_spawner/easy,
/turf/open/floor/naturalstone,
/area/under/cave)
"q" = (
/turf/open/floor/dirt,
/area/under/cave)
"y" = (
/turf/open/floor/naturalstone,
/area/under/cave)
"z" = (
/obj/effect/spawner/map_spawner/necropolis/water_tiles,
/turf/open/floor/naturalstone,
/area/under/cave)
"B" = (
/obj/effect/spawner/map_spawner/necropolis/random_dirty,
/turf/open/floor/dirt,
/area/under/cave)
"G" = (
/obj/effect/spawner/map_spawner/necropolis/mob_spawner/easy,
/turf/open/floor/dirt,
/area/under/cave)
"H" = (
/obj/effect/spawner/map_spawner/necropolis/random_dirty,
/obj/effect/spawner/map_spawner/necropolis/water_tiles,
/turf/open/floor/naturalstone,
/area/under/cave)
"K" = (
/obj/effect/spawner/map_spawner/necropolis/mob_spawner/goblin,
/turf/open/floor/naturalstone,
/area/under/cave)
"L" = (
/obj/effect/spawner/map_spawner/necropolis/shroom_clutter,
/turf/open/floor/naturalstone,
/area/under/cave)
"N" = (
/obj/effect/spawner/map_spawner/necropolis/mob_spawner/goblin,
/turf/open/floor/dirt,
/area/under/cave)
"Q" = (
/obj/effect/spawner/map_spawner/necropolis/random_dirty,
/obj/effect/spawner/map_spawner/necropolis/shroom_clutter,
/turf/open/floor/naturalstone,
/area/under/cave)
"U" = (
/obj/effect/spawner/map_spawner/necropolis/random_dirty,
/turf/open/floor/naturalstone,
/area/under/cave)
"Z" = (
/obj/effect/spawner/map_spawner/necropolis/random_rock_wall,
/turf/open/floor/naturalstone,
/area/under/cave)

(1,1,1) = {"
a
a
a
a
a
a
a
a
a
a
a
a
a
y
z
y
y
a
a
a
a
a
a
a
a
"}
(2,1,1) = {"
a
a
a
a
a
a
a
a
a
a
a
y
y
y
a
y
a
a
a
a
a
a
a
a
a
"}
(3,1,1) = {"
a
a
a
a
a
a
a
c
y
U
a
y
a
q
a
y
a
U
y
z
a
a
q
G
a
"}
(4,1,1) = {"
a
a
q
y
a
a
a
y
a
y
a
a
z
q
a
y
y
y
a
z
z
a
q
q
a
"}
(5,1,1) = {"
a
a
N
y
a
a
a
y
a
y
a
a
z
q
b
a
a
a
a
a
z
y
q
b
a
"}
(6,1,1) = {"
a
a
q
y
y
y
a
y
a
z
z
a
a
y
q
a
a
a
a
a
a
a
a
a
a
"}
(7,1,1) = {"
a
a
q
a
a
Q
y
y
a
a
a
y
y
U
q
y
y
a
a
a
a
a
a
a
a
"}
(8,1,1) = {"
a
a
q
a
a
y
a
a
a
a
y
y
a
a
q
a
y
y
y
Z
y
y
a
y
a
"}
(9,1,1) = {"
a
a
q
a
a
y
a
a
a
a
L
a
a
a
a
a
a
a
a
a
a
y
y
y
a
"}
(10,1,1) = {"
a
a
a
a
Z
y
y
a
a
a
L
a
a
a
a
a
a
a
a
a
y
y
a
a
a
"}
(11,1,1) = {"
y
a
a
b
y
a
y
y
y
y
y
a
a
a
a
a
a
a
a
a
L
a
a
a
a
"}
(12,1,1) = {"
y
y
y
q
a
a
L
y
a
a
H
a
a
a
z
z
y
c
a
a
y
y
y
a
a
"}
(13,1,1) = {"
y
a
a
a
a
a
y
a
a
a
z
y
a
a
z
a
a
y
y
a
a
a
y
a
U
"}
(14,1,1) = {"
y
a
a
a
a
a
y
a
a
a
y
a
a
a
z
a
a
a
U
a
a
a
y
y
c
"}
(15,1,1) = {"
y
a
a
a
a
a
y
q
b
a
y
c
a
a
z
y
a
a
y
a
a
a
a
a
y
"}
(16,1,1) = {"
y
a
y
q
q
q
q
a
a
y
y
y
y
Z
y
y
a
a
Z
a
a
a
a
a
Z
"}
(17,1,1) = {"
a
a
Z
q
B
N
q
q
a
Z
a
a
a
a
a
a
a
a
y
a
a
a
y
y
y
"}
(18,1,1) = {"
a
a
y
a
q
q
q
a
a
y
y
y
y
a
a
a
a
y
L
a
a
a
U
y
a
"}
(19,1,1) = {"
a
a
a
K
q
b
a
a
a
a
a
a
y
a
a
y
y
y
a
a
a
y
L
y
a
"}
(20,1,1) = {"
a
a
a
y
q
b
a
a
a
z
z
z
H
y
y
Z
a
a
a
a
y
y
a
a
a
"}
(21,1,1) = {"
a
a
a
y
y
a
a
a
a
y
a
a
a
a
a
y
a
a
a
a
y
a
a
a
a
"}
(22,1,1) = {"
a
a
a
q
q
y
y
y
a
y
y
a
a
a
a
y
a
a
a
Z
y
a
a
a
a
"}
(23,1,1) = {"
a
a
a
q
q
y
a
y
Z
y
y
y
y
y
a
y
y
y
y
y
a
a
a
a
a
"}
(24,1,1) = {"
a
a
a
a
q
q
a
y
a
a
a
a
a
y
a
y
a
a
a
a
a
a
a
a
a
"}
(25,1,1) = {"
a
a
a
a
a
y
y
y
a
a
a
y
y
y
y
y
a
a
a
a
a
a
a
a
a
"}
