//MAP CONVERTED BY dmm2tgm.py THIS HEADER COMMENT PREVENTS RECONVERSION, DO NOT REMOVE
"a" = (
/turf/open/floor/naturalstone,
/area/under/cave)
"b" = (
/turf/closed/mineral,
/area/under/cave)
"c" = (
/obj/effect/spawner/map_spawner/necropolis/random_rock_wall,
/turf/open/floor/naturalstone,
/area/under/cave)
"f" = (
/turf/open/water/marsh/deep,
/area/under/cave)
"i" = (
/obj/effect/spawner/map_spawner/necropolis/mob_spawner,
/turf/open/floor/naturalstone,
/area/under/cave)
"j" = (
/obj/effect/spawner/map_spawner/necropolis/shroom_clutter,
/turf/open/floor/naturalstone,
/area/under/cave)
"n" = (
/obj/effect/spawner/map_spawner/necropolis,
/turf/open/floor/naturalstone,
/area/under/cave)
"o" = (
/turf/open/water/marsh,
/area/under/cave)
"p" = (
/obj/effect/spawner/map_spawner/necropolis/mob_spawner/goblin,
/turf/open/floor/naturalstone,
/area/under/cave)
"q" = (
/obj/effect/spawner/map_spawner/necropolis/water_tiles,
/turf/open/floor/naturalstone,
/area/under/cave)
"r" = (
/obj/effect/landmark/map_load_mark/necropolis/z3_pillars,
/turf/open/floor/naturalstone,
/area/under/cave)
"F" = (
/turf/open/water/blood,
/area/under/cave)

(1,1,1) = {"
b
b
b
b
b
b
b
b
b
b
b
b
b
b
b
b
b
a
a
a
r
a
b
b
b
"}
(2,1,1) = {"
b
b
a
a
b
b
b
b
b
b
b
b
b
b
b
b
b
a
b
b
a
b
b
b
b
"}
(3,1,1) = {"
b
n
a
a
a
c
a
a
r
F
o
o
b
a
a
b
b
a
b
b
a
b
b
b
b
"}
(4,1,1) = {"
b
a
a
c
a
a
a
a
a
F
o
o
b
q
a
a
a
i
a
b
a
b
b
b
b
"}
(5,1,1) = {"
b
p
a
b
b
b
b
a
a
b
o
o
b
q
a
b
b
a
b
b
a
j
a
b
b
"}
(6,1,1) = {"
b
a
b
b
b
b
b
a
a
b
F
o
F
a
a
b
b
a
b
b
q
n
a
b
b
"}
(7,1,1) = {"
b
a
b
a
a
a
n
a
a
F
F
o
F
j
j
a
b
a
a
a
a
q
q
a
a
"}
(8,1,1) = {"
b
a
b
a
a
a
a
j
a
a
F
F
F
a
n
a
b
a
b
b
c
q
q
a
i
"}
(9,1,1) = {"
b
a
b
n
a
b
b
b
b
b
b
b
a
a
b
b
b
a
b
b
b
b
b
b
a
"}
(10,1,1) = {"
b
c
b
a
j
b
b
b
o
b
b
b
a
q
b
b
b
b
b
b
b
b
b
b
a
"}
(11,1,1) = {"
b
a
b
a
a
a
a
a
a
b
b
b
a
q
b
b
q
a
a
a
r
b
b
b
a
"}
(12,1,1) = {"
c
a
a
r
a
a
a
b
b
a
b
b
a
a
b
b
q
n
a
j
a
b
b
b
b
"}
(13,1,1) = {"
c
a
a
a
a
b
b
b
b
a
a
a
j
a
c
a
a
a
a
a
a
b
b
b
b
"}
(14,1,1) = {"
c
a
b
a
a
b
b
b
b
b
a
a
a
a
a
a
a
a
c
a
a
b
b
b
b
"}
(15,1,1) = {"
c
a
b
q
a
b
c
a
c
a
a
a
b
b
b
b
a
a
b
a
a
b
b
b
b
"}
(16,1,1) = {"
c
a
a
a
j
a
c
a
b
a
a
a
a
a
b
b
a
c
b
b
b
b
b
b
b
"}
(17,1,1) = {"
b
b
b
b
b
b
b
b
b
a
b
b
b
a
a
b
a
a
a
a
a
b
b
b
a
"}
(18,1,1) = {"
b
b
b
b
b
b
b
b
a
a
a
b
b
b
a
a
a
n
a
q
a
b
a
r
a
"}
(19,1,1) = {"
b
b
b
b
o
b
b
b
b
j
a
b
a
b
b
j
a
a
q
q
n
b
a
a
a
"}
(20,1,1) = {"
b
f
f
o
o
o
b
b
b
a
b
b
a
b
b
b
b
a
q
q
a
j
a
n
b
"}
(21,1,1) = {"
b
b
f
f
o
o
o
a
a
q
q
a
j
a
a
a
a
a
b
b
a
c
a
a
b
"}
(22,1,1) = {"
b
b
f
f
o
o
o
a
a
n
a
b
b
a
a
b
b
r
b
b
b
b
b
b
b
"}
(23,1,1) = {"
b
f
f
f
o
o
b
b
b
a
a
a
b
a
a
b
b
a
b
b
b
b
b
b
b
"}
(24,1,1) = {"
b
f
f
f
o
o
o
b
b
a
i
a
b
b
b
b
b
j
b
b
b
b
b
b
b
"}
(25,1,1) = {"
b
b
b
b
b
b
b
b
b
a
a
b
b
b
b
b
b
a
a
a
a
b
b
b
b
"}
