//MAP CONVERTED BY dmm2tgm.py THIS HEADER COMMENT PREVENTS RECONVERSION, DO NOT REMOVE
"a" = (
/turf/open/floor/grass/yel,
/area/indoors/cave)
"c" = (
/turf/closed/mineral/random/low_nonval,
/area/indoors/cave)
"j" = (
/turf/closed/mineral/silver,
/area/indoors/cave)
"v" = (
/turf/closed/mineral/random,
/area/indoors/cave)
"x" = (
/turf/closed/mineral/random/high_valuable,
/area/indoors/cave)
"B" = (
/obj/structure/fluff/signage{
	desc = "Take the bounty of the earth at your own risk!";
	name = "A warning"
	},
/turf/open/floor/naturalstone,
/area/indoors/cave)
"C" = (
/turf/closed/mineral,
/area/indoors/cave)
"L" = (
/turf/closed/mineral/copper,
/area/indoors/cave)
"N" = (
/turf/closed/mineral/gold,
/area/indoors/cave)
"Y" = (
/turf/open/floor/naturalstone,
/area/indoors/cave)

(1,1,1) = {"
C
C
C
C
C
C
C
C
C
Y
Y
C
C
C
C
C
C
C
C
C
C
C
C
C
C
"}
(2,1,1) = {"
C
C
C
C
C
C
C
C
C
B
Y
C
C
C
C
C
C
C
C
C
C
c
c
C
C
"}
(3,1,1) = {"
C
c
c
c
C
c
c
C
C
Y
Y
C
C
C
a
Y
Y
C
C
c
c
c
c
C
C
"}
(4,1,1) = {"
C
c
c
c
C
C
C
C
a
a
a
C
C
C
a
a
Y
C
c
c
c
c
c
C
C
"}
(5,1,1) = {"
C
c
c
c
c
c
C
C
a
a
a
a
C
C
a
a
a
C
c
c
c
c
c
C
C
"}
(6,1,1) = {"
C
C
c
C
c
c
C
C
a
a
C
a
N
C
a
a
a
C
C
c
c
c
c
C
C
"}
(7,1,1) = {"
C
c
c
c
c
c
C
C
C
C
L
a
Y
Y
Y
Y
a
Y
C
C
C
v
v
v
C
"}
(8,1,1) = {"
C
c
c
c
c
c
C
C
C
C
L
Y
Y
Y
Y
a
a
Y
Y
Y
C
v
v
v
x
"}
(9,1,1) = {"
C
C
C
C
C
C
C
C
C
L
L
Y
Y
N
N
C
C
C
a
a
C
v
v
v
C
"}
(10,1,1) = {"
C
C
C
C
a
a
a
a
Y
Y
Y
Y
Y
C
C
C
C
C
a
a
j
v
v
v
C
"}
(11,1,1) = {"
C
c
c
C
a
a
a
a
Y
Y
Y
a
Y
C
C
C
a
a
a
Y
C
j
j
j
C
"}
(12,1,1) = {"
Y
C
c
C
C
a
C
C
a
C
C
a
a
C
C
C
C
a
a
Y
a
C
j
j
C
"}
(13,1,1) = {"
Y
C
C
C
C
a
C
C
a
a
a
a
a
a
Y
Y
C
C
a
Y
a
C
j
j
C
"}
(14,1,1) = {"
Y
Y
Y
B
C
a
a
c
c
c
C
a
a
Y
Y
Y
C
C
a
Y
C
C
c
C
C
"}
(15,1,1) = {"
Y
Y
Y
Y
Y
Y
Y
Y
Y
a
a
a
Y
C
C
C
C
a
a
Y
C
C
c
C
C
"}
(16,1,1) = {"
Y
C
Y
C
C
C
a
Y
Y
Y
a
a
Y
Y
Y
C
C
a
a
Y
C
C
c
c
C
"}
(17,1,1) = {"
C
C
C
C
C
C
a
Y
C
C
C
a
a
C
Y
C
c
a
a
a
C
C
c
c
C
"}
(18,1,1) = {"
C
C
C
C
C
C
a
a
Y
Y
C
C
C
C
Y
C
c
a
a
a
C
C
C
C
C
"}
(19,1,1) = {"
C
C
C
C
C
C
Y
Y
C
Y
C
Y
Y
C
C
C
C
a
a
Y
Y
a
Y
C
C
"}
(20,1,1) = {"
C
c
c
C
C
C
Y
Y
C
Y
C
Y
Y
C
c
C
C
a
a
Y
a
a
Y
C
C
"}
(21,1,1) = {"
C
c
c
c
C
C
Y
Y
Y
Y
Y
Y
Y
a
a
a
a
a
a
C
a
a
Y
C
C
"}
(22,1,1) = {"
C
c
c
c
C
C
Y
Y
Y
Y
Y
Y
Y
Y
a
a
a
a
a
C
a
a
Y
C
C
"}
(23,1,1) = {"
C
c
c
c
C
C
Y
Y
C
C
C
Y
C
C
C
a
a
a
C
C
a
a
Y
C
C
"}
(24,1,1) = {"
C
C
C
c
c
C
C
C
C
C
C
Y
C
C
C
a
a
a
C
C
C
C
C
C
C
"}
(25,1,1) = {"
C
C
C
C
C
C
C
C
C
Y
Y
Y
Y
Y
C
C
C
C
C
C
c
c
c
C
C
"}
