//MAP CONVERTED BY dmm2tgm.py THIS HEADER COMMENT PREVENTS RECONVERSION, DO NOT REMOVE
"a" = (
/turf/closed/mineral,
/area/indoors/cave)
"p" = (
/turf/open/floor/grass/hell,
/area/indoors/cave)
"J" = (
/turf/open/floor/grass/eora,
/area/indoors/cave)
"O" = (
/turf/open/openspace,
/area/indoors/cave)
"R" = (
/turf/open/floor/naturalstone,
/area/indoors/cave)

(1,1,1) = {"
a
a
a
a
a
a
R
R
a
a
a
a
R
R
a
a
a
a
R
R
a
a
a
a
a
"}
(2,1,1) = {"
a
a
R
R
a
a
a
R
a
R
R
a
R
R
a
a
a
a
R
R
a
a
a
a
a
"}
(3,1,1) = {"
a
a
R
R
a
a
a
R
a
O
R
R
R
R
a
a
a
a
R
R
a
a
R
a
a
"}
(4,1,1) = {"
a
a
R
R
a
a
a
R
a
R
a
a
R
R
a
a
R
J
J
J
R
R
R
R
a
"}
(5,1,1) = {"
a
a
O
R
R
a
R
R
O
O
O
a
R
R
R
R
R
R
J
J
R
R
R
R
a
"}
(6,1,1) = {"
a
a
O
R
R
a
R
R
O
R
a
a
R
R
O
O
R
R
a
a
a
R
R
a
a
"}
(7,1,1) = {"
a
O
O
R
R
R
R
R
O
R
a
a
a
a
a
a
O
R
a
a
a
R
R
a
a
"}
(8,1,1) = {"
a
O
O
a
R
a
R
J
R
R
R
J
J
J
a
a
O
R
a
O
R
R
R
R
a
"}
(9,1,1) = {"
a
O
O
a
R
a
R
J
R
R
J
J
R
R
R
O
R
R
a
a
O
R
R
R
a
"}
(10,1,1) = {"
a
a
a
a
R
a
a
J
a
a
a
a
J
R
R
R
R
R
a
a
a
R
R
R
a
"}
(11,1,1) = {"
a
a
a
a
a
a
a
J
a
a
a
a
J
J
a
a
R
a
a
a
a
R
R
a
a
"}
(12,1,1) = {"
R
R
R
a
a
a
J
J
R
J
J
J
J
J
R
R
R
R
R
a
a
R
R
R
a
"}
(13,1,1) = {"
R
R
R
J
J
J
J
R
R
J
J
R
R
a
a
R
a
R
R
a
a
J
J
R
R
"}
(14,1,1) = {"
R
J
J
R
R
R
O
O
J
a
a
O
R
R
R
R
a
R
R
a
J
J
J
R
R
"}
(15,1,1) = {"
a
J
a
a
a
a
a
a
p
p
a
O
R
R
a
a
a
a
R
a
a
J
J
J
R
"}
(16,1,1) = {"
a
J
a
J
J
J
a
a
J
p
J
R
R
J
J
J
O
O
R
R
a
a
J
R
a
"}
(17,1,1) = {"
a
J
J
J
R
J
a
a
J
J
J
J
J
J
J
J
O
R
R
R
a
a
R
a
a
"}
(18,1,1) = {"
a
J
a
a
a
a
a
a
J
J
a
a
J
J
R
a
a
a
a
R
a
a
R
a
a
"}
(19,1,1) = {"
a
J
a
p
J
J
p
p
p
a
a
a
J
a
a
a
a
a
a
R
a
O
R
a
a
"}
(20,1,1) = {"
a
R
a
p
p
R
p
J
J
a
a
a
J
J
R
J
J
J
R
J
R
R
R
a
a
"}
(21,1,1) = {"
a
R
a
a
p
R
p
a
a
a
a
a
J
J
J
J
J
J
R
J
a
a
R
R
a
"}
(22,1,1) = {"
R
R
J
J
p
O
R
J
J
a
J
a
a
R
J
a
a
a
R
a
a
a
R
R
a
"}
(23,1,1) = {"
R
J
J
J
J
O
R
J
J
J
J
J
R
R
R
O
a
a
J
R
J
R
R
R
a
"}
(24,1,1) = {"
a
R
a
a
J
O
O
a
a
J
J
J
R
R
O
O
a
a
J
J
J
J
J
R
a
"}
(25,1,1) = {"
a
a
a
a
R
R
R
a
a
a
a
a
a
O
O
a
a
a
a
a
R
R
a
a
a
"}
