//MAP CONVERTED BY dmm2tgm.py THIS HEADER COMMENT PREVENTS RECONVERSION, DO NOT REMOVE
"a" = (
/turf/open/floor/naturalstone,
/area/indoors/cave)
"b" = (
/turf/closed/mineral,
/area/indoors/cave)
"f" = (
/turf/open/water/marsh/deep,
/area/indoors/cave)
"o" = (
/turf/open/water/marsh,
/area/indoors/cave)
"q" = (
/turf/open/openspace,
/area/indoors/cave)
"F" = (
/turf/open/water/blood,
/area/indoors/cave)

(1,1,1) = {"
b
b
b
b
b
b
b
b
b
b
b
b
b
b
b
b
b
a
a
a
a
a
b
b
b
"}
(2,1,1) = {"
b
b
a
a
b
b
b
b
b
b
b
b
b
b
b
b
b
a
b
b
a
b
b
b
b
"}
(3,1,1) = {"
b
a
q
a
a
a
a
a
a
F
o
o
b
a
a
b
b
a
b
b
a
b
b
b
b
"}
(4,1,1) = {"
b
a
q
a
a
a
a
a
a
F
o
o
b
a
a
a
a
a
a
b
a
b
b
b
b
"}
(5,1,1) = {"
b
a
a
a
b
b
b
a
a
b
o
o
b
a
a
b
b
a
b
b
a
a
a
b
b
"}
(6,1,1) = {"
b
a
b
b
b
b
b
a
a
b
F
o
F
a
a
b
b
a
b
b
a
q
q
b
b
"}
(7,1,1) = {"
b
a
b
a
a
a
a
a
a
F
F
o
F
a
a
a
b
a
a
a
a
q
a
a
a
"}
(8,1,1) = {"
b
a
b
a
a
a
a
a
a
a
F
F
F
a
a
a
b
a
b
b
a
a
a
a
a
"}
(9,1,1) = {"
b
a
b
a
a
b
b
b
b
b
b
b
a
a
b
b
b
a
b
b
b
b
b
b
a
"}
(10,1,1) = {"
b
a
b
a
a
b
b
b
o
b
b
b
a
a
b
b
b
b
b
b
b
b
b
b
a
"}
(11,1,1) = {"
b
a
b
a
q
q
a
a
a
b
b
b
q
a
b
b
a
a
q
q
a
b
b
b
a
"}
(12,1,1) = {"
a
a
a
a
a
a
a
b
b
a
b
b
a
q
b
b
a
a
q
q
a
b
b
b
b
"}
(13,1,1) = {"
a
a
a
a
a
b
b
b
b
a
a
a
a
a
a
a
a
a
q
q
a
b
b
b
b
"}
(14,1,1) = {"
a
a
b
a
a
b
b
b
b
b
a
a
a
a
a
a
a
a
q
q
a
b
b
b
b
"}
(15,1,1) = {"
a
a
b
a
a
b
a
a
a
a
a
a
b
b
b
b
a
a
b
b
b
b
b
b
b
"}
(16,1,1) = {"
a
a
a
a
a
a
a
a
b
a
a
a
a
a
b
b
a
a
b
b
b
b
b
b
b
"}
(17,1,1) = {"
b
b
b
b
b
b
b
b
b
a
b
b
b
a
a
b
a
a
a
a
a
b
b
b
a
"}
(18,1,1) = {"
b
b
b
b
b
b
b
b
a
a
a
b
b
b
a
a
a
a
a
a
a
b
a
a
a
"}
(19,1,1) = {"
b
b
b
b
o
b
b
b
b
a
a
b
a
b
b
a
a
a
a
q
a
b
a
a
a
"}
(20,1,1) = {"
b
f
f
o
o
o
b
b
b
a
b
b
a
b
b
b
b
a
b
b
a
a
a
a
b
"}
(21,1,1) = {"
b
b
f
f
o
o
o
a
a
a
a
a
a
a
q
a
a
a
b
b
a
a
a
a
b
"}
(22,1,1) = {"
b
b
f
f
o
o
o
a
a
a
a
b
b
b
q
b
b
a
b
b
b
b
b
b
b
"}
(23,1,1) = {"
b
f
f
f
o
o
b
b
b
a
a
a
b
q
q
b
b
a
b
b
b
b
b
b
b
"}
(24,1,1) = {"
b
f
f
f
o
o
o
b
b
a
a
a
b
b
b
b
b
a
b
b
b
b
b
b
b
"}
(25,1,1) = {"
b
b
b
b
b
b
b
b
b
a
a
b
b
b
b
b
b
a
a
a
a
b
b
b
b
"}
