//MAP CONVERTED BY dmm2tgm.py THIS HEADER COMMENT PREVENTS RECONVERSION, DO NOT REMOVE
"a" = (
/turf/closed/mineral,
/area/indoors/cave)
"D" = (
/turf/open/openspace,
/area/indoors/cave)
"K" = (
/turf/open/floor/naturalstone,
/area/indoors/cave)

(1,1,1) = {"
a
a
a
a
a
a
a
a
a
a
a
a
K
K
K
K
K
K
a
a
a
a
a
a
a
"}
(2,1,1) = {"
a
a
a
a
a
a
a
a
a
a
a
a
K
K
K
K
K
K
a
a
a
a
a
a
a
"}
(3,1,1) = {"
a
a
a
K
K
K
K
K
K
K
K
K
K
K
K
K
K
K
K
K
K
K
K
a
a
"}
(4,1,1) = {"
a
a
a
K
a
a
K
a
a
K
a
a
K
K
K
K
K
K
K
K
K
K
K
a
a
"}
(5,1,1) = {"
a
a
a
K
a
a
K
K
K
K
a
a
D
K
K
K
K
K
a
a
a
K
a
a
a
"}
(6,1,1) = {"
a
a
a
K
a
a
a
a
a
a
a
a
D
K
K
a
a
a
a
a
a
K
a
a
a
"}
(7,1,1) = {"
a
a
K
K
a
a
a
a
a
a
a
a
D
D
K
a
a
a
a
a
a
K
a
a
a
"}
(8,1,1) = {"
a
a
K
a
a
a
K
K
D
D
K
D
D
K
K
K
K
K
K
K
K
K
K
a
a
"}
(9,1,1) = {"
a
a
K
a
a
a
K
K
K
D
K
K
K
D
K
K
K
K
K
K
K
K
K
a
a
"}
(10,1,1) = {"
a
a
K
a
a
K
K
K
K
D
D
K
D
D
K
K
K
K
K
K
K
K
K
a
a
"}
(11,1,1) = {"
K
a
K
K
a
K
K
a
a
a
a
a
a
a
a
a
K
K
a
a
a
D
K
a
a
"}
(12,1,1) = {"
K
a
K
K
a
K
a
a
a
a
a
a
a
a
a
a
D
K
a
a
a
K
K
a
a
"}
(13,1,1) = {"
K
K
K
K
K
K
D
D
K
K
a
a
a
a
a
a
D
D
a
a
a
K
K
K
K
"}
(14,1,1) = {"
K
K
K
K
K
K
D
K
K
D
a
a
a
a
a
a
D
K
a
a
a
K
K
K
K
"}
(15,1,1) = {"
K
K
K
K
K
K
D
D
K
D
a
a
a
a
a
a
K
K
D
D
D
K
K
K
K
"}
(16,1,1) = {"
K
a
a
K
a
a
K
D
K
a
a
a
a
K
K
a
K
K
D
D
D
K
K
K
K
"}
(17,1,1) = {"
K
a
a
K
a
a
K
K
K
K
K
K
K
K
K
a
a
a
a
a
a
K
K
K
K
"}
(18,1,1) = {"
a
a
a
K
a
a
D
D
K
K
K
K
K
K
K
a
a
a
a
a
a
K
a
a
K
"}
(19,1,1) = {"
a
a
a
K
a
a
D
D
K
a
a
a
a
K
K
a
a
a
a
a
a
K
a
a
a
"}
(20,1,1) = {"
a
a
a
K
a
a
K
D
D
a
a
a
a
K
K
a
a
a
a
a
a
K
a
a
a
"}
(21,1,1) = {"
a
a
a
K
a
a
K
K
K
a
a
a
a
K
K
K
D
D
K
D
K
K
a
a
a
"}
(22,1,1) = {"
a
a
a
K
a
a
a
a
a
a
a
a
a
K
K
K
K
D
D
D
K
K
a
a
a
"}
(23,1,1) = {"
a
K
K
K
a
a
a
a
a
a
a
a
a
K
K
a
a
a
a
a
a
K
a
a
a
"}
(24,1,1) = {"
a
K
a
a
a
a
a
a
a
a
a
a
a
K
K
a
a
a
a
a
a
a
a
a
a
"}
(25,1,1) = {"
a
K
K
K
K
K
K
K
K
K
K
K
K
K
K
K
K
a
a
a
a
a
a
a
a
"}
