//MAP CONVERTED BY dmm2tgm.py THIS HEADER COMMENT PREVENTS RECONVERSION, DO NOT REMOVE
"ad" = (
/obj/effect/landmark/map_load_mark/necropolis/z3_pillars,
/turf/open/floor/dirt,
/area/under/cave)
"df" = (
/obj/effect/spawner/trap,
/turf/open/floor/hexstone,
/area/under/cave)
"fq" = (
/obj/item/restraints/legcuffs/beartrap/armed,
/turf/open/floor/hexstone,
/area/under/cave)
"hj" = (
/obj/effect/decal/cleanable/dirt,
/turf/open/floor/dirt,
/area/under/cave)
"hC" = (
/obj/effect/decal/cleanable/blood/gibs,
/turf/open/floor/naturalstone,
/area/under/cave)
"hR" = (
/obj/effect/decal/cleanable/blood/drip,
/obj/effect/spawner/map_spawner/necropolis/random_dirty,
/turf/open/floor/hexstone,
/area/under/cave)
"hY" = (
/obj/structure/bed/sleepingbag,
/obj/effect/decal/cleanable/dirt/cobweb,
/turf/open/floor/naturalstone,
/area/under/cave)
"jo" = (
/obj/effect/spawner/map_spawner/loot/armor,
/turf/open/floor/naturalstone,
/area/under/cave)
"kv" = (
/obj/structure/bed/sleepingbag,
/obj/effect/decal/cleanable/dirt,
/turf/open/floor/naturalstone,
/area/under/cave)
"ly" = (
/obj/effect/spawner/map_spawner/necropolis/water_tiles,
/turf/open/floor/hexstone,
/area/under/cave)
"lQ" = (
/obj/effect/spawner/map_spawner/loot/food,
/turf/open/floor/naturalstone,
/area/under/cave)
"lR" = (
/obj/structure/bed/sleepingbag,
/obj/item/restraints/legcuffs/beartrap/armed,
/turf/open/floor/naturalstone,
/area/under/cave)
"lX" = (
/obj/structure/bed/sleepingbag,
/obj/effect/decal/cleanable/dirt/cobweb/cobweb2,
/turf/open/floor/naturalstone,
/area/under/cave)
"lZ" = (
/turf/open/floor/dirt,
/area/under/cave)
"mA" = (
/obj/effect/decal/cleanable/dirt,
/obj/effect/decal/cleanable/dirt,
/turf/closed/mineral,
/area/under/cave)
"mH" = (
/obj/effect/decal/cleanable/blood/footprints,
/turf/open/floor/naturalstone,
/area/under/cave)
"or" = (
/obj/effect/decal/cleanable/blood/drip,
/obj/effect/spawner/map_spawner/loot,
/turf/open/floor/naturalstone,
/area/under/cave)
"ov" = (
/obj/effect/spawner/map_spawner/loot,
/obj/effect/decal/cleanable/glitter,
/turf/open/floor/naturalstone,
/area/under/cave)
"pi" = (
/obj/effect/spawner/map_spawner/necropolis/random_dirty,
/turf/open/floor/dirt,
/area/under/cave)
"pI" = (
/obj/effect/decal/cleanable/blood/footprints,
/obj/effect/decal/cleanable/dirt,
/obj/effect/spawner/map_spawner/necropolis,
/turf/open/floor/hexstone,
/area/under/cave)
"pM" = (
/obj/effect/decal/cleanable/dirt,
/turf/closed/mineral,
/area/under/cave)
"pQ" = (
/mob/living/carbon/human/species/skeleton/npc/easy,
/turf/open/floor/naturalstone,
/area/under/cave)
"pV" = (
/obj/structure/bars,
/turf/open/floor/naturalstone,
/area/under/cave)
"qh" = (
/obj/machinery/light/fueled/torchholder/l,
/obj/effect/decal/cleanable/dirt,
/turf/open/floor/hexstone,
/area/under/cave)
"qw" = (
/obj/structure/bed/sleepingbag,
/obj/effect/decal/cleanable/glitter,
/turf/open/floor/naturalstone,
/area/under/cave)
"sh" = (
/turf/closed/mineral,
/area/under/cave)
"sJ" = (
/obj/effect/decal/cleanable/dirt,
/turf/open/floor/naturalstone,
/area/under/cave)
"td" = (
/obj/structure/door/iron/bars/cell,
/obj/effect/decal/cleanable/blood/footprints,
/turf/open/floor/hexstone,
/area/under/cave)
"tB" = (
/turf/closed/wall/mineral/decostone/long,
/area/under/cave)
"tD" = (
/obj/structure/bars,
/turf/open/floor/hexstone,
/area/under/cave)
"tI" = (
/obj/machinery/light/fueled/torchholder/c,
/obj/effect/spawner/map_spawner/necropolis,
/turf/open/floor/hexstone,
/area/under/cave)
"ur" = (
/obj/machinery/light/fueled/torchholder/r,
/obj/effect/decal/cleanable/dirt,
/turf/open/floor/hexstone,
/area/under/cave)
"uC" = (
/obj/effect/spawner/map_spawner/loot,
/turf/open/floor/hexstone,
/area/under/cave)
"vv" = (
/obj/effect/decal/cleanable/dirt,
/obj/effect/decal/cleanable/dirt,
/obj/effect/decal/cleanable/dirt/cobweb,
/turf/open/floor/naturalstone,
/area/under/cave)
"vy" = (
/obj/effect/decal/cleanable/blood/splatter,
/turf/open/floor/hexstone,
/area/under/cave)
"wx" = (
/obj/effect/decal/cleanable/dirt,
/obj/effect/decal/cleanable/dirt,
/turf/open/floor/hexstone,
/area/under/cave)
"xe" = (
/obj/random/spider,
/turf/open/floor/hexstone,
/area/under/cave)
"xh" = (
/turf/closed/wall/mineral/decostone/end{
	dir = 8
	},
/area/under/cave)
"xt" = (
/obj/effect/decal/cleanable/blood,
/turf/open/floor/naturalstone,
/area/under/cave)
"yf" = (
/obj/effect/decal/cleanable/blood/gibs/body,
/turf/open/floor/naturalstone,
/area/under/cave)
"yx" = (
/obj/machinery/light/fueled/torchholder/r,
/obj/effect/spawner/map_spawner/necropolis/random_dirty,
/turf/open/floor/hexstone,
/area/under/cave)
"yI" = (
/obj/effect/spawner/map_spawner/necropolis/random_dirty,
/obj/effect/spawner/map_spawner/necropolis,
/turf/open/floor/hexstone,
/area/under/cave)
"yP" = (
/obj/structure/bed/sleepingbag,
/turf/open/floor/naturalstone,
/area/under/cave)
"zA" = (
/obj/effect/spawner/map_spawner/necropolis/water_tiles,
/obj/effect/spawner/map_spawner/necropolis/random_dirty,
/turf/open/floor/hexstone,
/area/under/cave)
"zG" = (
/obj/effect/decal/cleanable/blood/drip,
/obj/effect/decal/cleanable/dirt,
/obj/effect/spawner/map_spawner/necropolis/water_tiles,
/turf/open/floor/hexstone,
/area/under/cave)
"zT" = (
/obj/machinery/light/fueled/torchholder/l,
/turf/open/floor/hexstone,
/area/under/cave)
"Ag" = (
/obj/effect/decal/cleanable/blood/drip,
/turf/open/floor/hexstone,
/area/under/cave)
"AH" = (
/turf/open/floor/naturalstone,
/area/under/cave)
"Bt" = (
/obj/effect/decal/cleanable/dirt,
/obj/effect/spawner/map_spawner/necropolis,
/turf/open/floor/hexstone,
/area/under/cave)
"BM" = (
/obj/effect/spawner/map_spawner/necropolis/random_dirty,
/turf/open/floor/hexstone,
/area/under/cave)
"Ck" = (
/obj/machinery/light/fueled/torchholder/c,
/obj/effect/decal/cleanable/dirt,
/turf/open/floor/hexstone,
/area/under/cave)
"DJ" = (
/obj/effect/spawner/map_spawner/necropolis/water_tiles,
/turf/open/floor/dirt,
/area/under/cave)
"Ed" = (
/obj/structure/bed/sleepingbag,
/turf/open/floor/hexstone,
/area/under/cave)
"Ee" = (
/obj/effect/decal/cleanable/blood,
/turf/open/floor/hexstone,
/area/under/cave)
"Ev" = (
/obj/machinery/light/fueled/torchholder/c,
/obj/item/restraints/legcuffs/beartrap/armed,
/turf/open/floor/hexstone,
/area/under/cave)
"Fn" = (
/obj/effect/decal/cleanable/dirt,
/turf/open/floor/hexstone,
/area/under/cave)
"Gf" = (
/obj/structure/bars,
/turf/open/floor/dirt,
/area/under/cave)
"GQ" = (
/obj/machinery/light/fueled/torchholder/c,
/turf/open/floor/dirt,
/area/under/cave)
"GT" = (
/obj/effect/spawner/map_spawner/necropolis,
/turf/open/floor/hexstone,
/area/under/cave)
"Hz" = (
/obj/item/natural/rock,
/obj/effect/decal/cleanable/dirt,
/obj/effect/decal/cleanable/dirt,
/turf/open/floor/hexstone,
/area/under/cave)
"HW" = (
/obj/effect/decal/cleanable/blood/gibs/core,
/obj/effect/decal/cleanable/dirt,
/turf/open/floor/hexstone,
/area/under/cave)
"Ia" = (
/obj/effect/spawner/map_spawner/necropolis/shroom_clutter,
/turf/open/floor/dirt,
/area/under/cave)
"IV" = (
/obj/effect/decal/cleanable/blood/footprints,
/turf/open/floor/hexstone,
/area/under/cave)
"Jv" = (
/obj/machinery/light/fueled/torchholder/r,
/turf/open/floor/hexstone,
/area/under/cave)
"JD" = (
/turf/closed/wall/mineral/decostone/end{
	dir = 4
	},
/area/under/cave)
"MM" = (
/obj/effect/decal/cleanable/dirt/cobweb/cobweb2,
/turf/open/floor/naturalstone,
/area/under/cave)
"No" = (
/obj/effect/decal/cleanable/blood/drip,
/obj/effect/decal/cleanable/dirt,
/turf/open/floor/naturalstone,
/area/under/cave)
"OL" = (
/obj/effect/decal/cleanable/dirt,
/obj/effect/spawner/map_spawner/necropolis/water_tiles,
/turf/open/floor/hexstone,
/area/under/cave)
"Ph" = (
/obj/machinery/light/fueled/torchholder/c,
/turf/open/floor/hexstone,
/area/under/cave)
"Pq" = (
/obj/item/natural/rock,
/obj/effect/decal/cleanable/dirt,
/turf/open/floor/hexstone,
/area/under/cave)
"PD" = (
/obj/effect/decal/cleanable/blood/gibs,
/obj/effect/decal/cleanable/dirt,
/turf/open/floor/hexstone,
/area/under/cave)
"PN" = (
/obj/item/natural/rock,
/turf/open/floor/hexstone,
/area/under/cave)
"PT" = (
/obj/effect/spawner/map_spawner/loot/coin/low,
/obj/item/restraints/legcuffs/beartrap/armed,
/turf/open/floor/naturalstone,
/area/under/cave)
"Qd" = (
/turf/open/floor/hexstone,
/area/under/cave)
"Qo" = (
/obj/machinery/light/fueled/torchholder/c,
/obj/effect/spawner/map_spawner/necropolis/random_dirty,
/turf/open/floor/hexstone,
/area/under/cave)
"QS" = (
/obj/effect/landmark/map_load_mark/necropolis/z3_pillars,
/turf/closed/wall/mineral/decostone/long,
/area/under/cave)
"Rm" = (
/obj/effect/decal/cleanable/dirt,
/obj/effect/spawner/map_spawner/necropolis/random_dirty,
/turf/open/floor/hexstone,
/area/under/cave)
"RT" = (
/obj/effect/decal/cleanable/blood/gibs/body,
/obj/effect/decal/cleanable/glitter,
/turf/open/floor/naturalstone,
/area/under/cave)
"SE" = (
/obj/effect/decal/cleanable/dirt,
/obj/effect/spawner/map_spawner/necropolis/shroom_clutter,
/turf/open/floor/hexstone,
/area/under/cave)
"UF" = (
/obj/effect/spawner/map_spawner/loot/coin/low,
/turf/open/floor/naturalstone,
/area/under/cave)
"UX" = (
/obj/effect/decal/cleanable/dirt,
/obj/effect/spawner/map_spawner/necropolis/water_tiles,
/obj/effect/spawner/map_spawner/necropolis/random_dirty,
/turf/open/floor/hexstone,
/area/under/cave)
"VI" = (
/obj/effect/spawner/map_spawner/loot,
/turf/open/floor/naturalstone,
/area/under/cave)
"Xq" = (
/obj/effect/decal/cleanable/blood/gibs/down,
/turf/open/floor/naturalstone,
/area/under/cave)
"XA" = (
/obj/effect/spawner/map_spawner/necropolis/shroom_clutter,
/turf/open/floor/hexstone,
/area/under/cave)
"Yq" = (
/obj/machinery/light/fueled/torchholder/r,
/obj/effect/decal/cleanable/dirt,
/obj/effect/spawner/map_spawner/necropolis/water_tiles,
/turf/open/floor/hexstone,
/area/under/cave)
"YH" = (
/obj/structure/door/iron/bars/cell,
/turf/open/floor/hexstone,
/area/under/cave)

(1,1,1) = {"
sh
sh
sh
sh
sh
sh
sh
sh
sh
sh
Qd
SE
SE
Qd
Qd
Qd
sh
sh
sh
sh
sh
sh
sh
sh
sh
"}
(2,1,1) = {"
sh
Qd
Qd
Qd
Qd
Qd
BM
BM
Qd
sh
Qd
pM
mA
HW
Fn
pM
sh
Pq
Qd
Qd
Ia
lZ
lZ
ad
sh
"}
(3,1,1) = {"
sh
Qd
Qd
DJ
ly
BM
BM
BM
yx
Qd
OL
ly
ly
Qd
Jv
Qd
Qd
Qd
Qd
Qd
Jv
Qd
Ia
lZ
sh
"}
(4,1,1) = {"
sh
Qd
lZ
DJ
Qd
Qd
tB
tB
tB
tB
Ph
Qd
tB
tB
tB
tB
Ph
Qd
tB
tB
tB
tB
Qo
pi
sh
"}
(5,1,1) = {"
sh
Qd
Ia
DJ
ly
Qd
xh
hY
UF
tD
Qd
df
tD
RT
qw
xh
Qd
GT
xh
yP
AH
tD
Qd
pi
sh
"}
(6,1,1) = {"
sh
Qd
Ia
DJ
ly
Qd
YH
lQ
hC
tD
Bt
Qd
tD
ov
pQ
YH
Qd
Qd
YH
AH
yf
tD
BM
BM
sh
"}
(7,1,1) = {"
sh
Qd
lZ
ly
ly
Qd
JD
yP
AH
tD
Fn
Fn
tD
MM
qw
JD
Qd
Fn
JD
yP
VI
tD
BM
Qd
sh
"}
(8,1,1) = {"
sh
Qd
lZ
Qd
Qd
Qd
tB
tB
tB
tB
Ck
Qd
tB
tB
tB
tB
tI
Qd
tB
tB
tB
tB
Qo
Qd
sh
"}
(9,1,1) = {"
sh
Qd
Qd
Ag
XA
Qd
Qd
BM
BM
BM
Qd
Qd
yI
BM
fq
Qd
OL
ly
OL
OL
ly
Qd
Qd
sh
sh
"}
(10,1,1) = {"
sh
sh
sh
Qd
Qd
Ee
Rm
Qd
Jv
Qd
BM
yI
Rm
Rm
ur
PD
Fn
OL
ly
Qd
Yq
zG
Fn
Fn
Qd
"}
(11,1,1) = {"
AH
Qd
Qd
PN
Qd
Qd
tB
tB
tB
QS
Ph
Qd
tB
tB
tB
tB
Ph
Fn
tB
tB
tB
tB
Ph
Qd
Qd
"}
(12,1,1) = {"
AH
Qd
sh
Qd
Qd
Qd
xh
yP
VI
tD
Qd
ly
tD
sJ
yP
xh
Qd
Fn
xh
yP
pQ
tD
Qd
sh
Qd
"}
(13,1,1) = {"
AH
Qd
IV
pI
IV
IV
td
mH
Xq
tD
Qd
ly
tD
or
AH
YH
Qd
Fn
YH
VI
xt
tD
Qd
PN
ly
"}
(14,1,1) = {"
AH
Qd
Qd
Qd
Qd
Qd
JD
yP
xt
tD
Qd
ly
tD
AH
lR
JD
Qd
Fn
JD
lX
jo
tD
Qd
pM
ly
"}
(15,1,1) = {"
AH
Qd
Qd
df
Fn
Fn
tB
tB
tB
tB
Ph
Qd
tB
tB
tB
tB
Ph
Bt
tB
tB
tB
tB
Ev
pM
ly
"}
(16,1,1) = {"
AH
Qd
sh
Qd
Fn
Hz
Fn
Qd
BM
BM
Ee
Qd
BM
Fn
Fn
Fn
Fn
Qd
OL
ly
Fn
Fn
Fn
pM
Qd
"}
(17,1,1) = {"
sh
sh
sh
Ia
lZ
Fn
Bt
Fn
ur
Qd
BM
BM
BM
Qd
Jv
Qd
Fn
OL
ly
ly
Yq
OL
Rm
Rm
Qd
"}
(18,1,1) = {"
sh
Qd
Qd
Ia
Ia
XA
tB
tB
tB
tB
GQ
Fn
tB
tB
tB
tB
Ph
Qd
tB
tB
tB
tB
Ph
BM
sh
"}
(19,1,1) = {"
sh
Qd
sh
lZ
lZ
Ia
xh
lZ
uC
pV
Qd
Qd
tD
vv
yP
xh
Qd
Fn
xh
yP
AH
tD
ly
BM
sh
"}
(20,1,1) = {"
sh
pi
sh
sh
XA
lZ
YH
lZ
DJ
Gf
DJ
hj
tD
No
PT
YH
GT
wx
YH
lZ
lZ
tD
ly
hR
sh
"}
(21,1,1) = {"
sh
pi
DJ
sh
Qd
Qd
JD
Ed
DJ
Gf
DJ
hj
tD
No
kv
JD
Qd
Fn
JD
lZ
VI
tD
ly
Fn
sh
"}
(22,1,1) = {"
sh
BM
Rm
BM
ly
Qd
tB
tB
tB
tB
Ph
Fn
tB
tB
tB
tB
Ph
Bt
tB
tB
tB
tB
Ck
Qd
sh
"}
(23,1,1) = {"
sh
xe
Fn
Hz
Fn
UX
OL
Qd
zT
Qd
Qd
Qd
vy
Qd
zT
Qd
XA
Qd
ly
ly
qh
Fn
wx
XA
sh
"}
(24,1,1) = {"
sh
Qd
BM
BM
zA
Qd
ly
Fn
Qd
sh
Qd
pM
pM
Fn
pM
sh
sh
Qd
PN
ly
OL
OL
Fn
Qd
sh
"}
(25,1,1) = {"
sh
sh
sh
sh
sh
sh
sh
sh
sh
sh
Qd
Qd
Qd
Qd
Qd
Qd
sh
sh
sh
sh
sh
sh
sh
sh
sh
"}
