//MAP CONVERTED BY dmm2tgm.py THIS HEADER COMMENT PREVENTS RECONVERSION, DO NOT REMOVE
"a" = (
/turf/open/floor/grass/healthy,
/area/indoors/cave)
"b" = (
/obj/structure/flora/ausbushes/sparsegrass,
/mob/living/simple_animal/hostile/retaliate/bat,
/turf/open/floor/grass/mixyel,
/area/indoors/cave)
"c" = (
/obj/structure/flora/tree,
/turf/open/floor/grass/mixyel,
/area/indoors/cave)
"e" = (
/obj/structure/flora/ausbushes/ppflowers,
/turf/open/floor/grass/healthy,
/area/indoors/cave)
"f" = (
/obj/structure/flora/tree/dead_bush,
/obj/structure/flora/ausbushes/sparsegrass,
/turf/open/floor/grass/healthy,
/area/indoors/cave)
"h" = (
/obj/structure/flora/tree/dead_bush,
/turf/open/floor/grass/mixyel,
/area/indoors/cave)
"j" = (
/obj/structure/flora/ausbushes/fullgrass,
/turf/open/floor/grass/healthy,
/area/indoors/cave)
"k" = (
/turf/closed/mineral,
/area/indoors/cave)
"l" = (
/obj/structure/flora/tree/dead_bush,
/turf/open/floor/grass/healthy,
/area/indoors/cave)
"m" = (
/obj/structure/flora/ausbushes/palebush,
/turf/open/floor/grass/healthy,
/area/indoors/cave)
"n" = (
/turf/open/floor/grass/mixyel,
/area/indoors/cave)
"o" = (
/obj/structure/flora/grass/bush,
/obj/structure/flora/ausbushes/sparsegrass,
/turf/open/floor/grass/healthy,
/area/indoors/cave)
"q" = (
/obj/machinery/light/fueled/firebowl/stump,
/turf/open/floor/grass/healthy,
/area/indoors/cave)
"r" = (
/obj/structure/flora/tree/dead_bush,
/obj/structure/flora/ausbushes/fullgrass,
/turf/open/floor/grass/healthy,
/area/indoors/cave)
"s" = (
/obj/structure/flora/tree/dead_bush,
/obj/structure/flora/ausbushes/ppflowers,
/turf/open/floor/grass/healthy,
/area/indoors/cave)
"u" = (
/obj/structure/flora/grass/bush,
/obj/structure/flora/ausbushes/fullgrass,
/turf/open/floor/grass/healthy,
/area/indoors/cave)
"w" = (
/obj/machinery/light/fueled/firebowl/stump,
/turf/open/floor/grass/mixyel,
/area/indoors/cave)
"x" = (
/obj/structure/flora/ausbushes/ppflowers,
/obj/structure/flora/ausbushes/ppflowers,
/turf/open/floor/grass/mixyel,
/area/indoors/cave)
"y" = (
/obj/structure/flora/tree/dead_bush,
/obj/structure/flora/ausbushes/sparsegrass,
/mob/living/simple_animal/hostile/retaliate/bat,
/turf/open/floor/grass/healthy,
/area/indoors/cave)
"z" = (
/obj/structure/flora/grass/bush,
/turf/open/floor/grass/mixyel,
/area/indoors/cave)
"A" = (
/obj/structure/flora/ausbushes/sparsegrass,
/turf/closed/mineral,
/area/indoors/cave)
"B" = (
/turf/open/floor/naturalstone,
/area/indoors/cave)
"F" = (
/obj/structure/flora/ausbushes/palebush,
/turf/open/floor/grass/mixyel,
/area/indoors/cave)
"H" = (
/obj/structure/flora/grass/bush_meagre,
/turf/open/floor/grass/mixyel,
/area/indoors/cave)
"I" = (
/obj/structure/flora/grass/bush,
/turf/open/floor/grass/healthy,
/area/indoors/cave)
"K" = (
/obj/structure/flora/grass/bush,
/obj/structure/flora/ausbushes/sparsegrass,
/turf/open/floor/grass/mixyel,
/area/indoors/cave)
"M" = (
/mob/living/simple_animal/hostile/retaliate/bat,
/turf/open/floor/grass/healthy,
/area/indoors/cave)
"N" = (
/obj/structure/flora/grass/bush_meagre,
/turf/open/floor/grass/healthy,
/area/indoors/cave)
"P" = (
/obj/structure/flora/ausbushes/sparsegrass,
/mob/living/simple_animal/hostile/retaliate/bat,
/turf/open/floor/grass/healthy,
/area/indoors/cave)
"Q" = (
/obj/structure/flora/tree/dead_bush,
/obj/structure/flora/ausbushes/sparsegrass,
/turf/open/floor/grass/mixyel,
/area/indoors/cave)
"R" = (
/obj/structure/flora/ausbushes/sparsegrass,
/obj/structure/flora/ausbushes/sparsegrass,
/turf/open/floor/grass/healthy,
/area/indoors/cave)
"S" = (
/mob/living/simple_animal/hostile/retaliate/bat,
/turf/open/floor/grass/mixyel,
/area/indoors/cave)
"U" = (
/obj/structure/flora/ausbushes/sparsegrass,
/turf/open/floor/grass/mixyel,
/area/indoors/cave)
"V" = (
/obj/structure/flora/ausbushes/sparsegrass,
/turf/open/floor/grass/healthy,
/area/indoors/cave)
"W" = (
/obj/structure/flora/ausbushes/ppflowers,
/turf/open/floor/grass/mixyel,
/area/indoors/cave)
"X" = (
/obj/structure/flora/ausbushes/fullgrass,
/turf/open/floor/grass/mixyel,
/area/indoors/cave)
"Y" = (
/obj/structure/flora/ausbushes/sparsegrass,
/obj/structure/flora/ausbushes/sparsegrass,
/turf/open/floor/grass/mixyel,
/area/indoors/cave)

(1,1,1) = {"
k
k
k
k
k
k
k
k
k
k
k
B
B
n
n
n
B
k
k
k
k
k
k
k
k
"}
(2,1,1) = {"
k
n
n
U
U
U
n
n
n
n
k
n
B
n
B
k
k
k
n
U
U
U
n
n
k
"}
(3,1,1) = {"
k
n
l
V
P
n
z
n
Y
n
k
k
B
k
B
B
B
B
n
z
n
h
n
n
k
"}
(4,1,1) = {"
k
n
I
a
y
a
l
n
U
n
k
B
B
k
k
k
k
n
n
n
a
j
j
n
k
"}
(5,1,1) = {"
k
n
n
M
q
a
a
n
H
n
k
k
k
k
k
k
k
n
l
a
I
a
q
n
k
"}
(6,1,1) = {"
k
h
b
V
X
n
m
a
n
n
z
n
n
U
U
a
n
U
V
V
V
M
n
H
k
"}
(7,1,1) = {"
k
n
n
n
n
z
n
a
n
n
n
X
X
U
Y
V
z
n
j
a
V
j
n
n
k
"}
(8,1,1) = {"
k
k
k
k
W
a
s
h
z
n
S
S
n
H
n
l
a
a
a
W
l
j
X
n
k
"}
(9,1,1) = {"
B
B
n
k
S
a
a
a
n
X
j
M
z
n
n
w
n
I
j
W
W
a
U
U
k
"}
(10,1,1) = {"
B
n
B
k
n
a
a
N
n
n
l
a
a
n
n
H
a
a
n
a
a
n
n
n
k
"}
(11,1,1) = {"
B
B
B
k
n
l
x
n
n
a
a
n
n
n
h
n
n
X
S
r
a
z
n
k
k
"}
(12,1,1) = {"
B
n
k
B
n
a
z
n
a
N
n
X
n
n
n
n
a
a
M
P
R
n
k
k
B
"}
(13,1,1) = {"
B
n
B
B
n
a
n
h
q
a
U
z
U
n
a
a
Q
Y
U
n
X
n
k
B
B
"}
(14,1,1) = {"
B
n
k
k
n
n
n
X
a
f
n
n
c
a
z
a
a
n
h
U
z
n
B
n
B
"}
(15,1,1) = {"
B
B
n
B
n
n
M
S
n
o
W
n
n
e
a
n
n
z
a
n
n
n
k
n
B
"}
(16,1,1) = {"
B
n
B
k
n
X
a
j
n
n
n
W
z
a
e
X
n
X
a
a
a
n
k
B
B
"}
(17,1,1) = {"
k
k
k
k
n
H
V
a
n
X
z
n
n
a
n
n
n
a
a
a
a
n
k
k
n
"}
(18,1,1) = {"
k
n
n
n
n
n
a
r
a
U
n
S
j
N
n
h
n
M
u
q
a
z
n
k
k
"}
(19,1,1) = {"
k
n
U
n
n
F
z
U
n
n
a
a
a
j
n
X
n
a
e
a
n
n
n
n
k
"}
(20,1,1) = {"
k
n
n
K
n
n
n
n
X
h
n
I
a
a
l
n
X
z
a
l
a
V
a
n
k
"}
(21,1,1) = {"
k
n
z
a
j
h
n
X
n
H
w
n
n
V
k
k
A
U
U
V
a
V
V
n
k
"}
(22,1,1) = {"
k
n
a
I
a
U
n
h
n
n
n
n
n
n
U
V
n
n
n
a
M
h
V
U
k
"}
(23,1,1) = {"
k
w
a
l
a
o
n
F
n
k
k
k
k
k
B
B
B
k
n
U
n
z
n
U
k
"}
(24,1,1) = {"
k
n
n
n
n
n
n
n
n
k
n
n
B
B
B
B
B
k
n
Y
n
n
n
n
k
"}
(25,1,1) = {"
k
k
k
k
k
k
k
k
k
k
B
B
B
n
n
n
B
k
k
k
k
k
k
k
k
"}
