//MAP CONVERTED BY dmm2tgm.py THIS HEADER COMMENT PREVENTS RECONVERSION, DO NOT REMOVE
"aD" = (
/obj/structure/bars/cemetery,
/obj/structure/bars/cemetery,
/turf/open/floor/dirt,
/area/under/cave)
"aZ" = (
/obj/structure/closet/crate/coffin,
/obj/effect/spawner/map_spawner/loot/coin/low,
/turf/open/floor/churchmarble,
/area/under/cave)
"bg" = (
/obj/structure/closet/crate/coffin,
/obj/effect/decal/cleanable/dirt,
/turf/open/floor/churchmarble,
/area/under/cave)
"ci" = (
/turf/open/floor/dirt/road,
/area/under/cave)
"en" = (
/obj/structure/closet/dirthole/grave,
/obj/effect/spawner/map_spawner/loot/coin/low,
/turf/open/floor/dirt/road,
/area/under/cave)
"fB" = (
/obj/effect/spawner/map_spawner/necropolis/random_dirty,
/turf/open/floor/greenstone,
/area/under/cave)
"hY" = (
/obj/structure/closet/dirthole/grave,
/obj/effect/spawner/map_spawner/loot/weapon,
/turf/open/floor/dirt/road,
/area/under/cave)
"iC" = (
/obj/machinery/light/fueled/firebowl/standing/blue,
/turf/open/floor/churchmarble,
/area/under/cave)
"jx" = (
/obj/effect/spawner/map_spawner/necropolis/random_dirty,
/turf/open/floor/dirt,
/area/under/cave)
"jJ" = (
/obj/structure/flora/pillar,
/turf/open/floor/churchmarble,
/area/under/cave)
"kd" = (
/obj/effect/spawner/map_spawner/necropolis/water_tiles,
/turf/open/floor/cobblerock,
/area/under/cave)
"kU" = (
/obj/structure/closet/dirthole/grave,
/obj/effect/spawner/map_spawner/loot,
/turf/open/floor/dirt,
/area/under/cave)
"lk" = (
/obj/structure/closet/dirthole/grave,
/obj/structure/gravemarker,
/obj/effect/mob_spawn/human/corpse/damaged{
	flavour_text = "The body of some poor soul."
	},
/turf/open/floor/dirt/road,
/area/under/cave)
"lC" = (
/obj/structure/closet/dirthole/grave,
/obj/structure/gravemarker,
/obj/effect/mob_spawn/human/corpse/damaged{
	flavour_text = "The body of some poor soul."
	},
/obj/effect/spawner/map_spawner/loot,
/turf/open/floor/dirt/road,
/area/under/cave)
"mM" = (
/obj/item/natural/stone,
/turf/open/floor/greenstone,
/area/under/cave)
"nB" = (
/obj/effect/spawner/map_spawner/necropolis/random_rock_wall,
/turf/open/floor/dirt,
/area/under/cave)
"oV" = (
/obj/effect/landmark/map_load_mark/necropolis/z3_pillars,
/turf/closed/mineral,
/area/under/cave)
"pk" = (
/turf/closed/mineral,
/area/under/cave)
"rv" = (
/obj/item/natural/stone,
/obj/structure/bars/cemetery,
/turf/open/floor/dirt,
/area/under/cave)
"rX" = (
/turf/open/floor/cobblerock,
/area/under/cave)
"sq" = (
/obj/effect/landmark/map_load_mark/necropolis/z3_pillars,
/turf/open/floor/greenstone,
/area/under/cave)
"sD" = (
/obj/machinery/light/fueled/wallfire/candle/blue/l,
/obj/effect/decal/cleanable/dirt,
/obj/structure/closet/crate/crafted_closet,
/turf/open/floor/churchmarble,
/area/under/cave)
"sE" = (
/turf/open/floor/greenstone,
/area/under/cave)
"tQ" = (
/obj/structure/closet/dirthole/grave,
/turf/open/floor/dirt/road,
/area/under/cave)
"ur" = (
/obj/item/natural/stone,
/turf/closed/wall/mineral/stone,
/area/under/cave)
"uO" = (
/obj/structure/closet/crate/coffin,
/turf/open/floor/churchmarble,
/area/under/cave)
"uV" = (
/obj/structure/closet/dirthole/grave,
/obj/structure/gravemarker,
/obj/effect/mob_spawn/human/corpse/damaged{
	flavour_text = "The body of some poor soul."
	},
/obj/effect/spawner/map_spawner/loot/coin/low,
/turf/open/floor/dirt,
/area/under/cave)
"vp" = (
/obj/machinery/light/fueled/firebowl/standing/blue,
/turf/open/floor/greenstone,
/area/under/cave)
"wo" = (
/obj/item/natural/stone,
/turf/open/floor/dirt/road,
/area/under/cave)
"xp" = (
/obj/machinery/light/fueled/wallfire/candle/blue/r,
/obj/effect/decal/cleanable/dirt,
/obj/structure/closet/crate/chest/old_crate,
/obj/item/weapon/shovel,
/obj/item/weapon/shovel,
/obj/item/flashlight/flare/torch/lantern/bronzelamptern,
/obj/item/natural/bundle/stick,
/obj/item/natural/bundle/cloth/roll,
/turf/open/floor/churchmarble,
/area/under/cave)
"xA" = (
/obj/structure/closet/dirthole/grave,
/obj/structure/gravemarker,
/obj/effect/mob_spawn/human/corpse/damaged{
	flavour_text = "The body of some poor soul."
	},
/obj/effect/spawner/map_spawner/loot/coin/low,
/turf/open/floor/dirt/road,
/area/under/cave)
"zX" = (
/obj/structure/bars/cemetery,
/turf/open/floor/greenstone,
/area/under/cave)
"AF" = (
/obj/effect/decal/cleanable/dirt,
/obj/machinery/light/fueled/wallfire/candle/blue/r,
/turf/open/floor/churchmarble,
/area/under/cave)
"AT" = (
/obj/machinery/light/fueled/firebowl/stump,
/turf/open/floor/dirt,
/area/under/cave)
"BB" = (
/obj/structure/closet/dirthole/grave,
/obj/structure/gravemarker,
/obj/effect/spawner/map_spawner/loot,
/turf/open/floor/dirt,
/area/under/cave)
"CW" = (
/turf/closed/wall/mineral/stone,
/area/under/cave)
"Ek" = (
/obj/structure/bars/cemetery,
/obj/structure/bars/cemetery,
/turf/open/floor/greenstone,
/area/under/cave)
"Fe" = (
/mob/living/simple_animal/hostile/retaliate/mimic,
/turf/open/floor/churchmarble,
/area/under/cave)
"FL" = (
/turf/open/floor/churchmarble,
/area/under/cave)
"HF" = (
/obj/structure/closet/dirthole/grave,
/turf/open/floor/greenstone,
/area/under/cave)
"IE" = (
/obj/machinery/light/fueled/wallfire/candle/blue/r,
/obj/structure/closet/crate/crafted_closet,
/turf/open/floor/churchmarble,
/area/under/cave)
"IJ" = (
/obj/structure/fluff/walldeco/stone,
/turf/closed/wall/mineral/decostone/moss/blue,
/area/under/cave)
"Jo" = (
/obj/machinery/light/fueled/wallfire/candle/blue/l,
/obj/structure/closet/crate/chest/old_crate,
/obj/item/weapon/shovel,
/obj/item/weapon/shovel,
/obj/item/flashlight/flare/torch/lantern/bronzelamptern,
/obj/item/natural/bundle/stick,
/obj/item/natural/bundle/cloth/roll,
/turf/open/floor/churchmarble,
/area/under/cave)
"Jp" = (
/obj/structure/closet/dirthole/grave,
/turf/open/floor/dirt,
/area/under/cave)
"JR" = (
/obj/structure/bars/cemetery,
/turf/open/floor/dirt,
/area/under/cave)
"KZ" = (
/obj/effect/spawner/map_spawner/necropolis/water_tiles,
/turf/open/floor/dirt,
/area/under/cave)
"Lu" = (
/obj/machinery/light/fueled/wallfire/candle/blue/l,
/turf/open/floor/churchmarble,
/area/under/cave)
"LD" = (
/obj/structure/window/stained/silver,
/turf/open/floor/churchmarble,
/area/under/cave)
"MP" = (
/obj/effect/spawner/map_spawner/necropolis/random_rock_wall,
/turf/open/floor/greenstone,
/area/under/cave)
"PA" = (
/obj/effect/spawner/map_spawner/necropolis,
/turf/open/floor/dirt,
/area/under/cave)
"PD" = (
/turf/open/floor/dirt,
/area/under/cave)
"PF" = (
/obj/effect/spawner/map_spawner/necropolis/water_tiles,
/turf/open/floor/greenstone,
/area/under/cave)
"PO" = (
/turf/closed/wall/mineral/decostone/moss/blue,
/area/under/cave)
"Qw" = (
/obj/structure/closet/crate/coffin,
/obj/effect/decal/cleanable/dirt,
/obj/effect/spawner/map_spawner/loot/coin/low,
/turf/open/floor/churchmarble,
/area/under/cave)
"QP" = (
/obj/item/natural/stone,
/turf/open/floor/dirt,
/area/under/cave)
"Rj" = (
/obj/structure/door/stone,
/turf/open/floor/churchmarble,
/area/under/cave)
"Rt" = (
/obj/effect/spawner/map_spawner/necropolis/random_rock_wall,
/turf/open/floor/cobblerock,
/area/under/cave)
"Su" = (
/obj/effect/decal/cleanable/dirt,
/turf/open/floor/churchmarble,
/area/under/cave)
"Tf" = (
/turf/closed/wall/mineral/decostone/moss/blue/end,
/area/under/cave)
"TV" = (
/obj/machinery/light/fueled/firebowl/stump,
/turf/open/floor/dirt/road,
/area/under/cave)
"UM" = (
/obj/effect/spawner/map_spawner/necropolis,
/turf/open/floor/greenstone,
/area/under/cave)
"Wl" = (
/obj/effect/decal/cleanable/dirt,
/obj/item/natural/stone,
/turf/open/floor/churchmarble,
/area/under/cave)
"WY" = (
/turf/closed/wall/mineral/decostone,
/area/under/cave)
"Xb" = (
/obj/effect/spawner/map_spawner/necropolis/water_tiles,
/turf/open/floor/dirt/road,
/area/under/cave)
"Zs" = (
/obj/structure/closet/dirthole/grave,
/obj/structure/gravemarker,
/obj/effect/mob_spawn/human/corpse/damaged{
	flavour_text = "The body of some poor soul."
	},
/turf/open/floor/dirt,
/area/under/cave)

(1,1,1) = {"
pk
pk
pk
oV
pk
pk
pk
pk
pk
fB
jx
PD
PD
PD
PF
PF
pk
pk
pk
pk
pk
pk
pk
pk
oV
"}
(2,1,1) = {"
pk
pk
pk
pk
pk
pk
pk
pk
pk
fB
pk
pk
rX
pk
pk
PF
pk
pk
pk
pk
pk
pk
pk
pk
pk
"}
(3,1,1) = {"
pk
pk
pk
sE
sE
sE
sE
sE
sE
sE
sE
sE
rX
pk
rX
rX
sE
PD
nB
KZ
PF
PF
PF
pk
pk
"}
(4,1,1) = {"
pk
pk
pk
sE
zX
WY
LD
WY
WY
LD
WY
WY
mM
PD
MP
MP
MP
QP
sE
sE
sE
kd
kd
pk
pk
"}
(5,1,1) = {"
pk
pk
UM
mM
JR
Jp
sE
tQ
sE
xA
ci
Jp
sE
sE
PD
PO
LD
PO
LD
PO
sE
rX
PF
pk
pk
"}
(6,1,1) = {"
pk
pk
sE
sE
aD
rX
sE
sE
rX
rX
TV
ci
ci
sE
Tf
PO
bg
PO
bg
PO
PO
sE
sE
pk
pk
"}
(7,1,1) = {"
pk
pk
rX
rX
zX
lC
PF
tQ
rX
tQ
sE
tQ
sE
sE
LD
Qw
Su
Lu
Su
Qw
LD
sE
sE
pk
pk
"}
(8,1,1) = {"
pk
pk
PD
rX
zX
kd
PF
ci
rX
ci
ci
sE
rX
rX
PO
PO
Su
jJ
FL
PO
PO
rX
sE
pk
pk
"}
(9,1,1) = {"
pk
pk
sE
QP
rv
tQ
PF
tQ
PD
Jp
PD
BB
ci
rX
IJ
iC
Su
Wl
Su
PO
PO
rX
PD
pk
pk
"}
(10,1,1) = {"
sE
pk
PF
PD
zX
sE
ci
PD
AT
PD
rX
ci
ci
rX
Rj
Su
Su
FL
Su
Fe
LD
PD
pk
pk
pk
"}
(11,1,1) = {"
jx
pk
PF
KZ
zX
en
ci
lk
sE
kU
rX
tQ
sE
sE
IJ
iC
Wl
Su
FL
PO
PO
sE
pk
sE
sE
"}
(12,1,1) = {"
fB
PD
PF
KZ
zX
ci
sE
rX
rX
sE
rX
rX
PD
PD
PO
PO
Su
jJ
Wl
PO
PO
sE
PD
rX
PF
"}
(13,1,1) = {"
PD
pk
sE
sE
zX
lk
sE
tQ
sE
lk
sE
tQ
sE
QP
LD
Qw
Su
AF
Su
aZ
LD
sE
pk
pk
PF
"}
(14,1,1) = {"
PD
pk
pk
sE
zX
PD
sE
rX
ci
PD
QP
sE
sE
PD
PO
PO
bg
PO
uO
PO
PO
sE
rX
pk
sE
"}
(15,1,1) = {"
jx
nB
rX
sE
zX
hY
PD
lk
Xb
en
sE
lk
sE
UM
PD
PO
LD
PO
LD
PO
sE
UM
rX
PF
PF
"}
(16,1,1) = {"
fB
nB
rX
rX
zX
sE
PD
PF
Xb
Xb
Xb
sE
sE
sE
sE
PD
sE
sE
sE
nB
MP
sE
pk
pk
sE
"}
(17,1,1) = {"
pk
pk
PD
sE
zX
tQ
wo
HF
ci
tQ
PD
lk
rX
rX
rX
PA
sE
sE
rX
Rt
rX
sE
PD
UM
sE
"}
(18,1,1) = {"
pk
pk
sE
MP
zX
sE
TV
sE
ci
sE
PD
sE
sE
rX
rX
PD
CW
CW
CW
CW
ur
CW
sE
pk
pk
"}
(19,1,1) = {"
pk
pk
MP
nB
Ek
Jp
ci
uV
sE
Jp
AT
kU
UM
sE
sE
vp
CW
sD
FL
FL
Jo
CW
sE
pk
pk
"}
(20,1,1) = {"
pk
pk
sE
sE
JR
ci
PD
PD
PD
rX
rX
sE
rX
rX
PD
PD
Rj
FL
Su
Su
FL
CW
sE
pk
pk
"}
(21,1,1) = {"
pk
PD
sE
sq
JR
Zs
sE
kU
PD
Zs
rX
Zs
rX
UM
sE
vp
CW
IE
Su
Su
xp
CW
sE
pk
pk
"}
(22,1,1) = {"
pk
PD
pk
sE
JR
WY
LD
WY
WY
LD
WY
WY
sE
PD
PD
sE
CW
CW
CW
CW
CW
CW
sE
pk
oV
"}
(23,1,1) = {"
pk
PD
PD
PD
sE
sE
MP
MP
MP
sE
sE
sE
rX
rX
pk
rX
sE
sE
Rt
Rt
MP
sE
sE
pk
pk
"}
(24,1,1) = {"
pk
PD
PD
PD
pk
pk
pk
pk
pk
pk
sE
pk
pk
pk
rX
sE
pk
pk
pk
pk
pk
pk
pk
pk
pk
"}
(25,1,1) = {"
pk
pk
pk
pk
pk
pk
pk
pk
pk
pk
jx
jx
jx
PD
sE
sE
pk
pk
pk
pk
pk
pk
pk
pk
pk
"}
