//MAP CONVERTED BY dmm2tgm.py THIS HEADER COMMENT PREVENTS RECONVERSION, DO NOT REMOVE
"a" = (
/turf/closed/wall/mineral/decostone/moss/blue/end,
/area/indoors/cave)
"b" = (
/obj/structure/bars/cemetery,
/turf/open/floor/grass/yel,
/area/indoors/cave)
"d" = (
/obj/structure/bars/cemetery,
/turf/open/floor/grass/red,
/area/indoors/cave)
"e" = (
/obj/structure/door/stone,
/turf/open/floor/churchmarble,
/area/indoors/cave)
"f" = (
/obj/item/natural/stone,
/turf/open/floor/grass/red,
/area/indoors/cave)
"g" = (
/obj/structure/closet/dirthole/grave,
/obj/effect/spawner/map_spawner/loot,
/turf/open/floor/grass/yel,
/area/indoors/cave)
"h" = (
/obj/item/natural/stone,
/turf/open/floor/grass/yel,
/area/indoors/cave)
"i" = (
/obj/structure/closet/dirthole/grave,
/obj/structure/gravemarker,
/obj/effect/mob_spawn/human/corpse/damaged{
	flavour_text = "The body of some poor soul."
	},
/obj/effect/spawner/map_spawner/loot/coin/low,
/turf/open/floor/grass/yel,
/area/indoors/cave)
"j" = (
/turf/open/floor/grass/yel{
	dir = 4
	},
/area/indoors/cave)
"k" = (
/turf/open/floor/grass/red,
/area/indoors/cave)
"l" = (
/obj/machinery/light/fueled/firebowl/stump,
/turf/open/floor/grass/red,
/area/indoors/cave)
"m" = (
/turf/closed/wall/mineral/decostone,
/area/indoors/cave)
"n" = (
/obj/structure/closet/dirthole/grave,
/obj/structure/gravemarker,
/obj/effect/spawner/map_spawner/loot,
/turf/open/floor/grass/yel,
/area/indoors/cave)
"o" = (
/turf/closed/mineral,
/area/indoors/cave)
"p" = (
/obj/structure/closet/dirthole/grave,
/obj/structure/gravemarker,
/obj/effect/mob_spawn/human/corpse/damaged{
	flavour_text = "The body of some poor soul."
	},
/turf/open/floor/grass/yel,
/area/indoors/cave)
"r" = (
/obj/machinery/light/fueled/wallfire/candle/blue/l,
/turf/open/floor/churchmarble,
/area/indoors/cave)
"s" = (
/turf/closed/wall/mineral/stone,
/area/indoors/cave)
"t" = (
/obj/structure/fluff/walldeco/stone,
/turf/closed/wall/mineral/decostone/moss/blue,
/area/indoors/cave)
"u" = (
/obj/effect/decal/cleanable/dirt,
/obj/item/natural/stone,
/turf/open/floor/churchmarble,
/area/indoors/cave)
"v" = (
/obj/structure/closet/dirthole/grave,
/turf/open/floor/grass/red,
/area/indoors/cave)
"w" = (
/obj/machinery/light/fueled/firebowl/stump,
/turf/open/floor/dirt/road,
/area/indoors/cave)
"x" = (
/obj/structure/closet/dirthole/grave,
/turf/open/floor/grass/yel,
/area/indoors/cave)
"y" = (
/obj/structure/window/stained/silver,
/turf/open/floor/churchmarble,
/area/indoors/cave)
"z" = (
/obj/item/natural/stone,
/obj/structure/bars/cemetery,
/turf/open/floor/grass/red,
/area/indoors/cave)
"A" = (
/turf/closed/wall/mineral/decostone/moss/blue,
/area/indoors/cave)
"B" = (
/turf/open/floor/dirt/road,
/area/indoors/cave)
"C" = (
/obj/structure/closet/crate/coffin,
/obj/effect/decal/cleanable/dirt,
/obj/effect/spawner/map_spawner/loot/coin/low,
/turf/open/floor/churchmarble,
/area/indoors/cave)
"D" = (
/turf/open/floor/churchmarble,
/area/indoors/cave)
"E" = (
/obj/structure/closet/dirthole/grave,
/obj/effect/spawner/map_spawner/loot/coin/low,
/turf/open/floor/grass/yel,
/area/indoors/cave)
"F" = (
/obj/structure/closet/dirthole/grave,
/obj/effect/spawner/map_spawner/loot/weapon,
/turf/open/floor/grass/red,
/area/indoors/cave)
"G" = (
/obj/effect/decal/cleanable/dirt,
/turf/open/floor/churchmarble,
/area/indoors/cave)
"H" = (
/obj/structure/closet/dirthole/grave,
/obj/structure/gravemarker,
/obj/effect/mob_spawn/human/corpse/damaged{
	flavour_text = "The body of some poor soul."
	},
/obj/effect/spawner/map_spawner/loot,
/turf/open/floor/grass/yel,
/area/indoors/cave)
"I" = (
/obj/machinery/light/fueled/wallfire/candle/blue/r,
/obj/effect/decal/cleanable/dirt,
/obj/structure/closet/crate/chest/old_crate,
/obj/item/weapon/shovel,
/obj/item/weapon/shovel,
/obj/item/flashlight/flare/torch/lantern/bronzelamptern,
/obj/item/natural/bundle/stick,
/obj/item/natural/bundle/cloth/roll,
/turf/open/floor/churchmarble,
/area/indoors/cave)
"J" = (
/turf/open/floor/cobblerock,
/area/indoors/cave)
"K" = (
/obj/structure/bars/cemetery,
/obj/structure/bars/cemetery,
/turf/open/floor/grass/yel,
/area/indoors/cave)
"L" = (
/obj/item/natural/stone,
/turf/closed/wall/mineral/stone,
/area/indoors/cave)
"M" = (
/obj/structure/closet/crate/coffin,
/turf/open/floor/churchmarble,
/area/indoors/cave)
"N" = (
/obj/effect/decal/cleanable/dirt,
/obj/machinery/light/fueled/wallfire/candle/blue/r,
/turf/open/floor/churchmarble,
/area/indoors/cave)
"O" = (
/obj/structure/bars/cemetery,
/obj/structure/bars/cemetery,
/turf/open/floor/grass/red,
/area/indoors/cave)
"P" = (
/obj/machinery/light/fueled/wallfire/candle/blue/l,
/obj/effect/decal/cleanable/dirt,
/obj/structure/closet/crate/crafted_closet,
/obj/item/clothing/shirt/robe/necra,
/obj/item/clothing/shirt/robe/necra,
/turf/open/floor/churchmarble,
/area/indoors/cave)
"Q" = (
/mob/living/simple_animal/hostile/retaliate/mimic,
/turf/open/floor/churchmarble,
/area/indoors/cave)
"R" = (
/obj/structure/closet/crate/coffin,
/obj/effect/spawner/map_spawner/loot/coin/low,
/turf/open/floor/churchmarble,
/area/indoors/cave)
"S" = (
/turf/open/floor/grass/yel,
/area/indoors/cave)
"T" = (
/obj/machinery/light/fueled/firebowl/standing/blue,
/turf/open/floor/churchmarble,
/area/indoors/cave)
"U" = (
/obj/structure/flora/pillar,
/turf/open/floor/churchmarble,
/area/indoors/cave)
"V" = (
/obj/machinery/light/fueled/firebowl/standing/blue,
/turf/open/floor/grass/yel,
/area/indoors/cave)
"W" = (
/obj/machinery/light/fueled/wallfire/candle/blue/l,
/obj/structure/closet/crate/chest/old_crate,
/obj/item/weapon/shovel,
/obj/item/weapon/shovel,
/obj/item/flashlight/flare/torch/lantern/bronzelamptern,
/obj/item/natural/bundle/stick,
/obj/item/natural/bundle/cloth/roll,
/turf/open/floor/churchmarble,
/area/indoors/cave)
"X" = (
/obj/structure/closet/dirthole/grave,
/obj/structure/gravemarker,
/obj/effect/mob_spawn/human/corpse/damaged{
	flavour_text = "The body of some poor soul."
	},
/obj/effect/spawner/map_spawner/loot/coin/low,
/turf/open/floor/grass/red,
/area/indoors/cave)
"Y" = (
/obj/machinery/light/fueled/wallfire/candle/blue/r,
/obj/structure/closet/crate/crafted_closet,
/obj/item/clothing/shirt/robe/necra,
/obj/item/clothing/shirt/robe/necra,
/turf/open/floor/churchmarble,
/area/indoors/cave)
"Z" = (
/obj/structure/closet/crate/coffin,
/obj/effect/decal/cleanable/dirt,
/turf/open/floor/churchmarble,
/area/indoors/cave)

(1,1,1) = {"
o
o
o
o
o
o
o
o
o
S
k
k
k
k
S
S
o
o
o
o
o
o
o
o
o
"}
(2,1,1) = {"
o
o
o
o
o
o
o
o
o
S
o
o
J
o
o
S
o
o
o
o
o
o
o
o
o
"}
(3,1,1) = {"
o
o
S
S
S
S
S
S
S
S
S
S
J
o
J
J
S
k
k
k
S
S
S
o
o
"}
(4,1,1) = {"
o
o
S
S
b
m
y
m
m
y
m
m
h
k
S
S
S
f
S
S
S
J
J
o
o
"}
(5,1,1) = {"
o
o
S
h
d
v
S
x
S
i
B
v
S
S
k
A
y
A
y
A
S
J
S
o
o
"}
(6,1,1) = {"
o
o
S
S
O
J
S
S
J
J
w
B
B
S
a
A
Z
A
Z
A
A
S
S
o
o
"}
(7,1,1) = {"
o
o
J
J
b
H
S
x
J
x
S
x
S
S
y
C
G
r
G
C
y
S
S
o
o
"}
(8,1,1) = {"
o
o
k
J
b
J
S
B
J
B
B
S
J
J
A
A
G
U
D
A
A
J
S
o
o
"}
(9,1,1) = {"
o
o
S
f
z
x
S
v
k
v
B
n
B
J
t
T
G
u
G
A
A
J
k
o
o
"}
(10,1,1) = {"
S
o
S
k
b
S
B
k
l
k
J
B
B
J
e
G
G
D
G
Q
y
k
o
o
o
"}
(11,1,1) = {"
k
o
S
k
b
E
B
p
S
g
J
x
S
S
t
T
u
G
D
A
A
S
o
S
S
"}
(12,1,1) = {"
S
k
S
k
b
B
S
J
J
S
J
J
k
k
A
A
G
U
u
A
A
S
k
J
S
"}
(13,1,1) = {"
k
o
S
S
b
p
S
x
S
p
S
x
S
f
y
C
G
N
G
R
y
S
o
o
S
"}
(14,1,1) = {"
k
o
o
S
b
k
S
J
B
k
f
S
S
k
A
A
Z
A
M
A
A
S
J
o
S
"}
(15,1,1) = {"
k
k
J
S
b
F
k
p
B
E
S
p
S
S
k
A
y
A
y
A
S
S
J
S
S
"}
(16,1,1) = {"
S
k
J
J
b
S
k
S
B
B
B
S
S
S
S
k
S
S
S
k
S
S
o
o
S
"}
(17,1,1) = {"
o
o
k
S
b
x
h
x
B
v
k
p
J
J
J
k
S
S
J
J
J
S
k
S
S
"}
(18,1,1) = {"
o
o
S
S
b
S
w
S
B
S
k
S
S
J
J
k
s
s
s
s
L
s
S
o
o
"}
(19,1,1) = {"
o
o
S
k
K
v
B
X
S
x
l
g
S
S
S
V
s
P
D
D
W
s
S
o
o
"}
(20,1,1) = {"
o
o
S
S
d
B
k
k
k
J
J
S
J
J
k
k
e
D
G
G
D
s
S
o
o
"}
(21,1,1) = {"
o
o
S
S
d
p
S
g
k
p
J
p
J
S
S
V
s
Y
G
G
I
s
S
o
o
"}
(22,1,1) = {"
o
o
S
S
d
m
y
m
m
y
m
m
S
k
k
S
s
s
s
s
s
s
S
o
o
"}
(23,1,1) = {"
o
o
S
S
j
S
S
S
S
S
S
S
J
J
o
J
S
S
J
J
S
S
S
o
o
"}
(24,1,1) = {"
o
o
o
o
o
o
o
o
o
o
S
o
o
o
J
S
o
o
o
o
o
o
o
o
o
"}
(25,1,1) = {"
o
o
o
o
o
o
o
o
o
o
k
k
k
k
S
S
o
o
o
o
o
o
o
o
o
"}
