//MAP CONVERTED BY dmm2tgm.py THIS HEADER COMMENT PREVENTS RECONVERSION, DO NOT REMOVE
"a" = (
/obj/structure/flora/grass/bush/wall/tall,
/turf/open/floor/grass/yel,
/area/indoors/cave)
"c" = (
/obj/structure/innocent_bush,
/turf/open/floor/grass/yel,
/area/indoors/cave)
"e" = (
/turf/closed/mineral,
/area/indoors/cave)
"i" = (
/obj/structure/flora/grass/bush/wall/tall,
/obj/structure/flora/grass/bush/wall/tall,
/obj/structure/flora/grass/bush/wall/tall,
/turf/open/floor/grass/yel,
/area/indoors/cave)
"r" = (
/obj/structure/flora/grass/bush/wall/tall,
/obj/structure/flora/grass/bush/wall/tall,
/turf/open/floor/grass/yel,
/area/indoors/cave)
"A" = (
/obj/structure/flora/grass/swampweed,
/turf/open/floor/grass/yel,
/area/indoors/cave)
"C" = (
/obj/structure/flora/ausbushes/sparsegrass,
/turf/open/floor/grass/yel,
/area/indoors/cave)
"M" = (
/turf/open/floor/grass/yel,
/area/indoors/cave)
"S" = (
/obj/structure/flora/grass,
/turf/open/floor/grass/yel,
/area/indoors/cave)

(1,1,1) = {"
e
e
e
e
e
e
e
e
e
e
M
M
M
M
M
M
e
e
e
e
e
e
e
e
e
"}
(2,1,1) = {"
e
M
M
M
M
M
M
C
M
a
M
a
a
a
M
a
a
M
C
M
M
M
a
M
e
"}
(3,1,1) = {"
e
M
a
a
M
a
a
a
M
a
M
a
M
M
M
a
a
a
a
a
a
M
M
M
e
"}
(4,1,1) = {"
e
M
a
M
C
a
a
a
M
M
a
a
M
a
a
a
a
a
a
r
a
C
a
M
e
"}
(5,1,1) = {"
e
M
a
M
a
r
a
a
a
C
M
a
M
a
a
a
a
a
a
a
a
M
a
M
e
"}
(6,1,1) = {"
e
M
a
M
a
a
a
a
a
a
M
M
M
M
M
C
M
M
M
a
a
M
a
M
e
"}
(7,1,1) = {"
e
M
a
S
M
M
C
M
M
a
a
a
A
a
a
a
a
a
M
a
a
M
a
M
e
"}
(8,1,1) = {"
e
M
a
a
a
a
M
a
M
M
C
C
M
a
a
a
a
a
C
a
a
M
a
M
e
"}
(9,1,1) = {"
e
M
a
S
M
M
M
a
a
r
r
i
a
r
r
a
a
a
M
a
a
M
a
M
e
"}
(10,1,1) = {"
e
a
a
M
a
a
M
a
r
C
M
M
M
M
M
M
C
M
M
M
M
M
a
a
e
"}
(11,1,1) = {"
M
M
M
M
a
a
M
a
r
M
a
a
r
r
r
a
M
a
a
a
r
a
a
a
M
"}
(12,1,1) = {"
M
M
a
a
a
a
M
a
c
M
a
a
M
C
M
M
M
a
M
C
M
C
M
M
M
"}
(13,1,1) = {"
M
M
a
M
M
M
M
a
a
M
a
a
a
a
a
a
M
a
M
a
a
a
a
a
M
"}
(14,1,1) = {"
M
M
a
M
a
a
a
a
r
M
a
M
M
C
M
M
C
a
a
a
a
M
M
M
M
"}
(15,1,1) = {"
M
M
a
M
M
M
M
A
M
M
a
M
a
a
a
a
M
a
M
M
C
M
a
C
M
"}
(16,1,1) = {"
M
M
a
M
a
M
a
M
a
M
M
C
a
M
a
a
M
a
M
a
M
a
a
M
M
"}
(17,1,1) = {"
e
M
a
M
a
M
a
M
r
a
r
a
a
M
a
a
M
a
M
a
a
a
a
M
e
"}
(18,1,1) = {"
e
M
a
M
a
M
a
M
M
M
M
M
M
M
C
r
C
a
M
a
M
a
a
M
e
"}
(19,1,1) = {"
e
M
a
a
a
M
a
M
a
a
a
r
r
a
M
a
M
a
M
a
M
a
a
M
e
"}
(20,1,1) = {"
e
M
C
M
M
M
i
M
a
M
M
M
M
a
M
a
a
a
M
a
M
a
a
M
e
"}
(21,1,1) = {"
e
M
a
a
a
M
a
M
a
a
a
a
M
a
C
M
M
M
a
a
C
M
C
M
e
"}
(22,1,1) = {"
e
M
a
a
a
M
a
M
a
a
a
a
M
a
M
a
a
M
a
a
a
a
a
M
e
"}
(23,1,1) = {"
e
M
a
a
a
M
a
M
M
M
M
a
M
a
M
a
a
M
a
a
a
r
a
M
e
"}
(24,1,1) = {"
e
M
C
M
C
M
a
a
a
a
M
a
M
a
M
a
a
M
M
C
M
M
C
M
e
"}
(25,1,1) = {"
e
e
e
e
e
e
e
e
e
e
M
M
M
M
M
M
e
e
e
e
e
e
e
e
e
"}
