//MAP CONVERTED BY dmm2tgm.py THIS HEADER COMMENT PREVENTS RECONVERSION, DO NOT REMOVE
"aF" = (
/obj/structure/closet/crate/chest/wicker,
/obj/effect/spawner/map_spawner/loot/food,
/obj/effect/spawner/map_spawner/loot/food,
/obj/effect/spawner/map_spawner/loot/food,
/obj/effect/spawner/map_spawner/loot/food,
/obj/effect/spawner/map_spawner/loot/food,
/obj/effect/spawner/map_spawner/loot/food,
/obj/effect/spawner/map_spawner/loot/food,
/turf/open/floor/ruinedwood/two,
/area/under/cave)
"dL" = (
/obj/structure/fermentation_keg/redwine,
/obj/machinery/light/fueled/torchholder/c,
/turf/open/floor/ruinedwood/two,
/area/under/cave)
"fx" = (
/obj/structure/chair/stool,
/turf/open/floor/ruinedwood/two,
/area/under/cave)
"fG" = (
/turf/open/floor/naturalstone,
/area/under/cave)
"gy" = (
/obj/structure/flora/ausbushes/sparsegrass,
/obj/structure/flora/ausbushes/sparsegrass,
/obj/structure/flora/ausbushes/sparsegrass,
/turf/open/floor/grass/mixyel,
/area/under/cave)
"gD" = (
/obj/structure/barricade/wooden/crude,
/turf/closed/wall/mineral/wood/window,
/area/under/cave)
"gJ" = (
/obj/structure/flora/ausbushes/sparsegrass,
/obj/structure/flora/ausbushes/sparsegrass,
/turf/open/floor/grass/mixyel,
/area/under/cave)
"ik" = (
/obj/structure/flora/ausbushes/sparsegrass,
/obj/structure/flora/grass/bush,
/turf/open/floor/grass/mixyel,
/area/under/cave)
"iP" = (
/obj/structure/bed/inn,
/obj/item/bedsheet/fabric,
/turf/open/floor/ruinedwood/two,
/area/under/cave)
"jd" = (
/turf/open/floor/grass/mixyel,
/area/under/cave)
"jw" = (
/obj/structure/table/wood/plain,
/obj/item/dice_cup/wooden,
/turf/open/floor/ruinedwood/two,
/area/under/cave)
"lQ" = (
/obj/structure/flora/ausbushes/sparsegrass,
/obj/structure/flora/ausbushes/sparsegrass,
/turf/open/floor/grass/cold,
/area/under/cave)
"mb" = (
/obj/structure/flora/grass/bush,
/turf/open/floor/grass/cold,
/area/under/cave)
"me" = (
/obj/structure/table/wood/nice/decorated,
/obj/machinery/light/fueled/torchholder/r,
/turf/open/floor/ruinedwood/two,
/area/under/cave)
"mT" = (
/obj/machinery/light/fueled/torchholder/c,
/turf/open/floor/ruinedwood/two,
/area/under/cave)
"nk" = (
/obj/machinery/light/fueled/torchholder/l,
/obj/structure/chair/stool,
/turf/open/floor/ruinedwood/two,
/area/under/cave)
"nC" = (
/obj/machinery/light/fueled/torchholder/r,
/turf/open/floor/ruinedwood/two,
/area/under/cave)
"oQ" = (
/turf/open/floor/dirt/road,
/area/under/cave)
"pN" = (
/obj/structure/fermentation_keg/distiller,
/turf/open/floor/ruinedwood/two,
/area/under/cave)
"pY" = (
/obj/structure/table/wood/counter/end{
	dir = 1
	},
/obj/effect/landmark/map_load_mark/necropolis/z3_pillars,
/turf/open/floor/ruinedwood/two,
/area/under/cave)
"qc" = (
/obj/structure/door/swing,
/turf/open/floor/ruinedwood/two,
/area/under/cave)
"qS" = (
/obj/effect/decal/cleanable/debris/wood,
/turf/open/floor/ruinedwood/two,
/area/under/cave)
"rc" = (
/obj/structure/table/wood/counter/end{
	dir = 10
	},
/turf/open/floor/ruinedwood/two,
/area/under/cave)
"rj" = (
/obj/effect/landmark/map_load_mark/necropolis/z3_pillars,
/turf/closed/mineral,
/area/under/cave)
"ry" = (
/obj/structure/bed/inn,
/obj/item/bedsheet/fabric,
/obj/effect/decal/cleanable/dirt,
/turf/open/floor/ruinedwood/two,
/area/under/cave)
"sA" = (
/turf/closed/mineral,
/area/under/cave)
"sU" = (
/obj/structure/chair/wood,
/turf/open/floor/ruinedwood/two,
/area/under/cave)
"tc" = (
/obj/structure/fermentation_keg/beer,
/turf/open/floor/ruinedwood/two,
/area/under/cave)
"tt" = (
/turf/closed/wall/mineral/wood,
/area/under/cave)
"uA" = (
/obj/effect/landmark/map_load_mark/necropolis/z3_pillars,
/turf/open/floor/ruinedwood/two,
/area/under/cave)
"vf" = (
/obj/machinery/light/fueled/torchholder/c{
	pixel_y = -1;
	dir = 1
	},
/obj/effect/decal/cleanable/dirt,
/turf/open/floor/ruinedwood/two,
/area/under/cave)
"vK" = (
/turf/closed/wall/mineral/wood/window,
/area/under/cave)
"ye" = (
/obj/effect/landmark/map_load_mark/necropolis/z3_pillars,
/turf/open/floor/grass/mixyel,
/area/under/cave)
"zm" = (
/obj/structure/flora/ausbushes/sparsegrass,
/obj/structure/flora/grass/bush,
/turf/open/floor/grass/cold,
/area/under/cave)
"zW" = (
/obj/effect/landmark/map_load_mark/necropolis/z3_pillars,
/turf/open/floor/naturalstone,
/area/under/cave)
"At" = (
/obj/structure/table/wood/plain,
/obj/item/reagent_containers/glass/cup/golden,
/turf/open/floor/ruinedwood/two,
/area/under/cave)
"Fb" = (
/obj/structure/table/wood/counter{
	dir = 1
	},
/turf/open/floor/ruinedwood/two,
/area/under/cave)
"Fr" = (
/obj/structure/flora/ausbushes/sparsegrass,
/turf/open/floor/grass/cold,
/area/under/cave)
"Gx" = (
/obj/structure/closet/crate/crafted_closet/inn,
/obj/item/clothing/armor/leather/hide,
/obj/item/clothing/armor/leather/jacket/sea,
/obj/item/clothing/armor/leather/vest/colored/butler,
/obj/item/clothing/armor/leather/vest/colored/random,
/obj/item/clothing/gloves/leather/masterwork,
/obj/item/clothing/gloves/leather/masterwork,
/obj/item/clothing/pants/tights/sailor,
/obj/item/clothing/pants/trou,
/obj/item/clothing/pants/trou,
/turf/open/floor/ruinedwood/two,
/area/under/cave)
"GX" = (
/turf/open/floor/grass/cold,
/area/under/cave)
"Iv" = (
/obj/machinery/light/fueled/torchholder/l,
/turf/open/floor/ruinedwood/two,
/area/under/cave)
"IB" = (
/obj/structure/flora/grass/bush,
/turf/open/floor/grass/mixyel,
/area/under/cave)
"IN" = (
/obj/structure/chair/stool,
/obj/effect/decal/cleanable/dirt,
/turf/open/floor/ruinedwood/two,
/area/under/cave)
"Jm" = (
/obj/effect/decal/cleanable/dirt,
/obj/effect/decal/cleanable/dirt,
/turf/open/floor/ruinedwood/two,
/area/under/cave)
"JA" = (
/obj/structure/table/wood/counter{
	dir = 1
	},
/obj/item/dice_cup/wooden{
	pixel_x = -3
	},
/obj/item/dice_cup/wooden{
	pixel_x = 7
	},
/obj/item/dice_cup/wooden{
	pixel_x = 17
	},
/obj/item/dice_cup/wooden{
	pixel_x = -11
	},
/turf/open/floor/ruinedwood/two,
/area/under/cave)
"Lh" = (
/obj/structure/door/window,
/turf/open/floor/grass/cold,
/area/under/cave)
"Lm" = (
/obj/machinery/light/fueled/torchholder/r,
/obj/effect/decal/cleanable/dirt,
/turf/open/floor/ruinedwood/two,
/area/under/cave)
"OR" = (
/obj/machinery/light/fueled/torchholder/c{
	dir = 1;
	pixel_y = -1
	},
/turf/open/floor/ruinedwood/two,
/area/under/cave)
"PG" = (
/obj/structure/door/red,
/turf/open/floor/ruinedwood/two,
/area/under/cave)
"QR" = (
/obj/effect/landmark/map_load_mark/necropolis/z3_pillars,
/turf/open/floor/dirt/road,
/area/under/cave)
"Ro" = (
/obj/structure/flora/ausbushes/sparsegrass,
/turf/open/floor/grass/mixyel,
/area/under/cave)
"Rp" = (
/obj/structure/chair/wood/alt/chair3{
	dir = 4
	},
/turf/open/floor/ruinedwood/two,
/area/under/cave)
"Rw" = (
/obj/effect/landmark/map_load_mark/necropolis/z3_pillars,
/turf/closed/wall/mineral/wood,
/area/under/cave)
"RB" = (
/obj/structure/chair/wood/alt/chair3{
	dir = 8
	},
/turf/open/floor/ruinedwood/two,
/area/under/cave)
"RQ" = (
/obj/structure/table/wood/plain,
/obj/item/toy/cards/deck,
/turf/open/floor/ruinedwood/two,
/area/under/cave)
"TH" = (
/obj/effect/decal/cleanable/dirt,
/turf/open/floor/ruinedwood/two,
/area/under/cave)
"Uw" = (
/turf/open/floor/ruinedwood/two,
/area/under/cave)
"Ys" = (
/obj/structure/chair/wood/alt/chair3,
/turf/open/floor/ruinedwood/two,
/area/under/cave)

(1,1,1) = {"
sA
sA
sA
rj
sA
sA
sA
sA
sA
sA
fG
fG
zW
fG
fG
fG
sA
sA
sA
sA
sA
sA
sA
sA
rj
"}
(2,1,1) = {"
sA
GX
mb
GX
GX
GX
GX
GX
jd
sA
sA
oQ
sA
oQ
oQ
oQ
sA
GX
GX
GX
GX
IB
GX
GX
sA
"}
(3,1,1) = {"
sA
GX
Fr
Ro
GX
zm
lQ
Ro
jd
sA
sA
sA
sA
oQ
oQ
sA
sA
GX
gJ
lQ
Ro
Ro
Fr
GX
sA
"}
(4,1,1) = {"
sA
Fr
Ro
Ro
GX
Fr
Fr
jd
GX
oQ
oQ
oQ
oQ
oQ
oQ
oQ
oQ
GX
IB
GX
gJ
Fr
gJ
Fr
sA
"}
(5,1,1) = {"
sA
Fr
Fr
jd
Ro
GX
GX
jd
GX
oQ
oQ
oQ
oQ
oQ
oQ
oQ
oQ
GX
jd
jd
lQ
Fr
Fr
Fr
sA
"}
(6,1,1) = {"
sA
GX
mb
GX
Fr
GX
oQ
oQ
oQ
oQ
oQ
oQ
oQ
oQ
oQ
oQ
oQ
oQ
oQ
GX
GX
GX
jd
Fr
sA
"}
(7,1,1) = {"
sA
Fr
GX
jd
mb
GX
oQ
oQ
oQ
oQ
oQ
oQ
oQ
oQ
oQ
oQ
oQ
oQ
oQ
oQ
oQ
oQ
jd
Fr
sA
"}
(8,1,1) = {"
sA
Fr
Ro
Ro
GX
GX
oQ
oQ
tt
tt
tt
vK
tt
Lh
tt
vK
tt
Rw
jd
oQ
oQ
oQ
jd
Ro
sA
"}
(9,1,1) = {"
sA
GX
GX
jd
GX
oQ
oQ
oQ
vK
dL
Uw
JA
nk
Uw
Iv
Uw
OR
tt
Ro
jd
oQ
oQ
Ro
Fr
sA
"}
(10,1,1) = {"
sA
sA
jd
GX
oQ
oQ
oQ
GX
gD
tc
TH
Fb
fx
TH
Uw
TH
Uw
tt
Fr
GX
oQ
oQ
jd
jd
sA
"}
(11,1,1) = {"
fG
sA
sA
oQ
oQ
oQ
oQ
jd
tt
pN
sU
Fb
fx
qS
Rp
Uw
TH
tt
Fr
jd
oQ
oQ
sA
sA
sA
"}
(12,1,1) = {"
fG
oQ
oQ
oQ
oQ
oQ
oQ
ye
tt
aF
TH
Fb
fx
Uw
RQ
Uw
Uw
vK
Ro
Ro
oQ
oQ
sA
oQ
fG
"}
(13,1,1) = {"
fG
oQ
oQ
oQ
oQ
oQ
oQ
jd
tt
mT
Uw
Fb
IN
TH
RB
Uw
vf
vK
mb
Ro
oQ
oQ
sA
oQ
fG
"}
(14,1,1) = {"
fG
oQ
sA
oQ
oQ
oQ
oQ
GX
tt
qc
rc
pY
fx
Uw
Rp
Uw
qS
vK
GX
lQ
GX
GX
oQ
oQ
fG
"}
(15,1,1) = {"
fG
GX
sA
GX
GX
GX
oQ
GX
tt
TH
TH
uA
TH
Uw
jw
Uw
Uw
tt
tt
tt
tt
tt
oQ
oQ
fG
"}
(16,1,1) = {"
sA
sA
sA
mb
GX
oQ
oQ
GX
gD
Uw
Ys
At
Ys
Uw
RB
Uw
TH
PG
Uw
Iv
Gx
tt
sA
oQ
fG
"}
(17,1,1) = {"
sA
Fr
Fr
GX
oQ
oQ
oQ
GX
vK
mT
Uw
Uw
nC
Uw
Lm
TH
OR
tt
TH
Jm
Uw
tt
oQ
oQ
fG
"}
(18,1,1) = {"
sA
GX
GX
GX
GX
oQ
oQ
oQ
tt
tt
tt
vK
tt
Lh
tt
vK
tt
tt
ry
me
iP
tt
oQ
sA
sA
"}
(19,1,1) = {"
sA
GX
oQ
oQ
GX
oQ
oQ
oQ
oQ
oQ
oQ
oQ
oQ
oQ
jd
gy
Ro
tt
tt
tt
tt
tt
GX
oQ
sA
"}
(20,1,1) = {"
sA
GX
GX
oQ
oQ
oQ
oQ
oQ
oQ
oQ
oQ
oQ
oQ
oQ
oQ
gJ
lQ
Fr
Fr
Ro
gJ
GX
oQ
oQ
sA
"}
(21,1,1) = {"
sA
mb
GX
GX
GX
oQ
oQ
oQ
GX
GX
Fr
GX
GX
oQ
oQ
jd
mb
oQ
oQ
oQ
Fr
oQ
oQ
oQ
sA
"}
(22,1,1) = {"
sA
GX
oQ
QR
GX
GX
oQ
oQ
GX
Ro
gJ
lQ
mb
oQ
oQ
oQ
oQ
oQ
oQ
oQ
oQ
oQ
oQ
oQ
rj
"}
(23,1,1) = {"
sA
Fr
GX
oQ
oQ
oQ
GX
GX
GX
gJ
gJ
Ro
GX
sA
oQ
oQ
sA
sA
oQ
oQ
oQ
oQ
oQ
oQ
sA
"}
(24,1,1) = {"
sA
GX
lQ
GX
GX
GX
GX
GX
mb
GX
GX
sA
sA
sA
sA
oQ
sA
sA
ik
lQ
lQ
jd
jd
GX
sA
"}
(25,1,1) = {"
sA
sA
sA
sA
sA
sA
sA
sA
sA
sA
sA
sA
fG
fG
fG
fG
fG
sA
sA
sA
sA
sA
sA
sA
sA
"}
