//MAP CONVERTED BY dmm2tgm.py THIS HEADER COMMENT PREVENTS RECONVERSION, DO NOT REMOVE
"a" = (
/obj/structure/flora/ausbushes/sparsegrass,
/turf/open/floor/grass/mixyel,
/area/indoors/cave)
"b" = (
/obj/machinery/light/fueled/hearth,
/turf/open/floor/grass/cold,
/area/indoors/cave)
"c" = (
/obj/machinery/anvil,
/turf/open/floor/grass/yel,
/area/indoors/cave)
"d" = (
/obj/structure/composter/full,
/turf/open/floor/grass/mixyel,
/area/indoors/cave)
"e" = (
/obj/structure/bed/hay,
/obj/machinery/light/fueled/torchholder/c,
/turf/open/floor/dirt/road,
/area/indoors/cave)
"f" = (
/obj/structure/closet/crate/chest/crate,
/obj/item/neuFarm/seed/onion,
/obj/item/neuFarm/seed/onion,
/obj/item/neuFarm/seed/onion,
/obj/item/neuFarm/seed/oat,
/obj/item/neuFarm/seed/oat,
/obj/item/neuFarm/seed/oat,
/obj/item/neuFarm/seed/pear,
/obj/item/neuFarm/seed/pear,
/obj/item/neuFarm/seed/poppy,
/obj/item/neuFarm/seed/poppy,
/obj/item/neuFarm/seed/coffee,
/obj/item/neuFarm/seed/coffee,
/obj/item/neuFarm/seed/coffee,
/obj/item/neuFarm/seed/apple,
/obj/item/neuFarm/seed/apple,
/obj/item/neuFarm/seed/apple,
/obj/item/neuFarm/seed/strawberry,
/obj/item/neuFarm/seed/strawberry,
/obj/item/neuFarm/seed/tamto,
/obj/item/neuFarm/seed/tamto,
/turf/open/floor/grass/mixyel,
/area/indoors/cave)
"g" = (
/obj/structure/closet/crate/chest/old_crate,
/obj/item/reagent_containers/food/snacks/butter,
/obj/item/reagent_containers/food/snacks/butter,
/obj/item/reagent_containers/food/snacks/butter,
/obj/item/reagent_containers/food/snacks/butter,
/obj/item/reagent_containers/food/snacks/egg,
/obj/item/reagent_containers/food/snacks/egg,
/obj/item/reagent_containers/food/snacks/egg,
/obj/effect/spawner/map_spawner/loot/food,
/obj/effect/spawner/map_spawner/loot/food,
/obj/effect/spawner/map_spawner/loot/food,
/obj/effect/spawner/map_spawner/loot/food,
/turf/open/floor/grass/cold,
/area/indoors/cave)
"i" = (
/turf/open/floor/naturalstone,
/area/indoors/cave)
"k" = (
/obj/structure/rack,
/obj/effect/spawner/map_spawner/loot/armor,
/turf/open/floor/dirt/road,
/area/indoors/cave)
"l" = (
/obj/structure/closet/crate/chest/old_crate,
/obj/item/reagent_containers/food/snacks/produce/vegetable/onion,
/obj/item/reagent_containers/food/snacks/produce/vegetable/onion,
/obj/item/reagent_containers/food/snacks/produce/vegetable/onion,
/obj/item/reagent_containers/food/snacks/produce/vegetable/onion,
/obj/item/reagent_containers/food/snacks/produce/vegetable/onion,
/obj/item/reagent_containers/food/snacks/produce/vegetable/potato,
/obj/item/reagent_containers/food/snacks/produce/vegetable/potato,
/obj/item/reagent_containers/food/snacks/produce/vegetable/potato,
/obj/item/reagent_containers/food/snacks/produce/vegetable/potato,
/obj/item/reagent_containers/food/snacks/egg,
/obj/effect/spawner/map_spawner/loot/food,
/obj/effect/spawner/map_spawner/loot/food,
/obj/effect/spawner/map_spawner/loot/food,
/turf/open/floor/grass/cold,
/area/indoors/cave)
"m" = (
/turf/open/floor/grass/cold,
/area/indoors/cave)
"n" = (
/obj/structure/flora/grass/bush_meagre,
/turf/open/floor/grass/eora,
/area/indoors/cave)
"o" = (
/obj/structure/table/wood/counter{
	dir = 1
	},
/obj/item/reagent_containers/glass/bucket/pot,
/turf/open/floor/grass/cold,
/area/indoors/cave)
"p" = (
/obj/structure/flora/ausbushes/leafybush,
/turf/open/floor/grass/yel,
/area/indoors/cave)
"q" = (
/obj/structure/flora/grass/bush,
/turf/open/floor/grass/eora,
/area/indoors/cave)
"s" = (
/obj/structure/flora/tree/dead_bush,
/turf/open/floor/grass/eora,
/area/indoors/cave)
"t" = (
/obj/structure/table/wood/counter{
	dir = 1
	},
/obj/item/cooking/pan,
/turf/open/floor/grass/cold,
/area/indoors/cave)
"v" = (
/obj/structure/flora/ausbushes/fullgrass,
/obj/structure/flora/ausbushes/fullgrass,
/turf/open/floor/grass/cold,
/area/indoors/cave)
"w" = (
/turf/open/floor/grass/eora,
/area/indoors/cave)
"x" = (
/obj/structure/rack,
/obj/effect/spawner/map_spawner/loot/weapon,
/turf/open/floor/dirt/road,
/area/indoors/cave)
"y" = (
/obj/structure/chair/stool,
/turf/open/floor/grass/yel,
/area/indoors/cave)
"z" = (
/obj/structure/flora/ausbushes/pointybush,
/turf/open/floor/grass/yel,
/area/indoors/cave)
"B" = (
/turf/open/floor/grass/mixyel,
/area/indoors/cave)
"C" = (
/obj/machinery/light/fueled/forge,
/turf/open/floor/grass/yel,
/area/indoors/cave)
"D" = (
/obj/structure/flora/ausbushes/sparsegrass,
/obj/structure/flora/ausbushes/sparsegrass,
/turf/open/floor/grass/mixyel,
/area/indoors/cave)
"H" = (
/obj/structure/bed/hay,
/turf/open/floor/dirt/road,
/area/indoors/cave)
"I" = (
/turf/closed/mineral,
/area/indoors/cave)
"J" = (
/obj/structure/tent_wall,
/turf/open/floor/grass/cold,
/area/indoors/cave)
"K" = (
/turf/open/floor/grass/yel,
/area/indoors/cave)
"L" = (
/obj/structure/roguetent,
/turf/open/floor/grass/cold,
/area/indoors/cave)
"M" = (
/obj/structure/chair/wood{
	dir = 4
	},
/turf/open/floor/grass/cold,
/area/indoors/cave)
"N" = (
/obj/structure/fermentation_keg/water,
/turf/open/floor/grass/yel,
/area/indoors/cave)
"O" = (
/turf/open/water,
/area/indoors/cave)
"P" = (
/obj/structure/flora/ausbushes/fullgrass,
/turf/open/floor/grass/cold,
/area/indoors/cave)
"Q" = (
/obj/machinery/light/fueled/campfire/densefire,
/turf/open/floor/grass/yel,
/area/indoors/cave)
"R" = (
/obj/structure/closet/crate/chest/crate,
/obj/item/weapon/hoe,
/obj/item/weapon/hoe,
/obj/item/weapon/shovel,
/obj/item/weapon/shovel,
/obj/item/reagent_containers/glass/bucket,
/obj/item/reagent_containers/glass/bucket,
/turf/open/floor/grass/mixyel,
/area/indoors/cave)
"U" = (
/obj/structure/flora/ausbushes/grassybush,
/turf/open/floor/grass/yel,
/area/indoors/cave)
"V" = (
/turf/open/floor/dirt/road,
/area/indoors/cave)
"W" = (
/obj/structure/closet/crate/chest/wicker,
/obj/item/ore/coal,
/obj/item/ore/coal,
/obj/item/ore/coal,
/obj/item/ore/coal,
/obj/item/ore/coal,
/obj/item/ore/coal,
/obj/item/ore/coal,
/obj/item/ore/coal,
/obj/item/ore/coal,
/obj/item/ore/coal,
/obj/item/ore/coal,
/obj/item/ore/coal,
/obj/item/ore/coal,
/obj/item/ore/coal,
/turf/open/floor/grass/cold,
/area/indoors/cave)
"Y" = (
/obj/structure/grindwheel,
/turf/open/floor/grass/yel,
/area/indoors/cave)
"Z" = (
/obj/machinery/light/fueled/torchholder/c,
/turf/open/floor/grass/cold,
/area/indoors/cave)

(1,1,1) = {"
I
I
I
I
I
I
I
I
I
I
i
i
i
i
i
i
i
I
I
I
I
I
I
I
I
"}
(2,1,1) = {"
I
I
I
I
I
I
I
I
I
I
I
I
i
i
i
I
I
I
I
I
I
I
I
I
I
"}
(3,1,1) = {"
I
e
V
k
J
m
M
m
M
v
m
m
V
V
V
w
w
q
w
s
w
w
w
I
I
"}
(4,1,1) = {"
I
H
V
x
J
Z
m
m
m
P
P
m
m
V
V
w
w
q
w
w
n
w
s
I
I
"}
(5,1,1) = {"
I
H
V
V
L
m
b
t
l
m
m
m
m
V
V
V
w
q
q
w
w
w
w
I
I
"}
(6,1,1) = {"
I
e
V
V
J
Z
b
o
g
m
m
P
P
m
V
V
w
w
w
w
q
w
w
I
I
"}
(7,1,1) = {"
I
J
J
J
J
m
m
W
m
m
m
P
m
m
V
V
V
w
n
w
q
q
w
I
I
"}
(8,1,1) = {"
I
m
m
m
m
m
V
V
V
V
m
m
m
m
m
V
V
w
n
w
s
w
w
I
I
"}
(9,1,1) = {"
I
I
P
m
V
V
V
V
V
V
V
O
O
m
m
V
V
w
q
w
w
w
w
I
I
"}
(10,1,1) = {"
i
I
P
m
V
V
K
K
V
V
V
O
O
O
V
V
V
w
q
w
n
w
s
I
i
"}
(11,1,1) = {"
i
I
P
P
V
V
K
K
V
V
O
O
O
O
V
V
w
w
w
w
w
w
w
I
i
"}
(12,1,1) = {"
i
I
m
V
V
V
p
K
V
O
O
O
O
O
O
V
w
w
w
s
w
w
V
i
i
"}
(13,1,1) = {"
i
i
V
V
V
K
K
K
V
O
O
O
O
O
O
O
w
n
w
w
w
V
V
I
i
"}
(14,1,1) = {"
i
i
V
K
K
p
K
O
O
O
O
O
O
O
O
O
O
w
w
w
V
V
V
I
i
"}
(15,1,1) = {"
i
i
V
K
K
K
O
O
O
O
O
O
O
O
O
O
O
w
V
V
V
V
V
i
i
"}
(16,1,1) = {"
i
I
p
K
z
U
K
K
V
O
O
O
O
O
O
O
O
w
V
V
a
B
V
i
i
"}
(17,1,1) = {"
I
I
K
K
K
K
K
V
V
V
V
V
O
O
O
V
V
V
V
B
a
a
B
I
i
"}
(18,1,1) = {"
I
I
K
U
K
z
K
V
V
V
V
B
O
O
O
V
V
V
B
B
a
B
B
I
I
"}
(19,1,1) = {"
I
I
K
K
y
K
U
K
K
V
V
V
a
B
O
B
B
B
B
a
a
a
B
I
I
"}
(20,1,1) = {"
I
I
K
p
K
K
K
K
K
U
V
V
V
B
B
a
B
B
B
a
B
a
B
I
I
"}
(21,1,1) = {"
I
I
y
K
Q
K
y
K
K
K
K
K
V
V
B
a
a
B
B
B
B
B
a
I
I
"}
(22,1,1) = {"
I
I
K
K
K
K
K
C
K
K
K
z
V
V
V
B
a
B
B
B
B
B
B
I
I
"}
(23,1,1) = {"
I
I
p
K
y
K
z
Y
c
N
K
K
V
V
V
V
V
D
a
R
f
d
B
I
I
"}
(24,1,1) = {"
I
I
I
I
I
I
I
I
I
I
I
I
i
i
i
I
i
I
I
I
I
I
I
I
I
"}
(25,1,1) = {"
I
I
I
I
I
I
I
I
I
I
I
i
i
i
i
i
i
I
I
I
I
I
I
I
I
"}
