//MAP CONVERTED BY dmm2tgm.py THIS HEADER COMMENT PREVENTS RECONVERSION, DO NOT REMOVE
"a" = (
/turf/open/floor/naturalstone,
/area/indoors/cave)
"c" = (
/obj/effect/decal/cleanable/blood/old,
/turf/open/floor/naturalstone,
/area/indoors/cave)
"e" = (
/obj/effect/decal/cleanable/blood/footprints,
/obj/effect/decal/cleanable/blood,
/turf/open/floor/naturalstone,
/area/indoors/cave)
"f" = (
/turf/open/openspace,
/area/indoors/cave)
"g" = (
/mob/living/carbon/human/species/goblin/cave,
/turf/open/floor/naturalstone,
/area/indoors/cave)
"h" = (
/obj/effect/decal/cleanable/blood/gibs/down,
/turf/open/floor/naturalstone,
/area/indoors/cave)
"k" = (
/obj/effect/decal/cleanable/blood/gibs/torso,
/turf/open/floor/naturalstone,
/area/indoors/cave)
"m" = (
/obj/effect/decal/cleanable/blood/tracks,
/obj/effect/decal/cleanable/blood/tracks,
/turf/open/floor/naturalstone,
/area/indoors/cave)
"n" = (
/obj/effect/decal/cleanable/blood/splatter,
/obj/effect/decal/cleanable/blood/gibs/up,
/turf/open/floor/naturalstone,
/area/indoors/cave)
"s" = (
/obj/effect/decal/cleanable/blood,
/turf/open/floor/naturalstone,
/area/indoors/cave)
"t" = (
/obj/effect/decal/cleanable/blood/footprints{
	dir = 1
	},
/turf/open/floor/naturalstone,
/area/indoors/cave)
"u" = (
/turf/closed/mineral,
/area/indoors/cave)
"v" = (
/obj/effect/decal/cleanable/blood/footprints{
	dir = 8
	},
/turf/open/floor/naturalstone,
/area/indoors/cave)
"w" = (
/obj/effect/decal/cleanable/blood/tracks,
/turf/open/floor/naturalstone,
/area/indoors/cave)
"x" = (
/obj/effect/decal/cleanable/blood/splatter,
/turf/open/floor/naturalstone,
/area/indoors/cave)
"y" = (
/obj/effect/decal/cleanable/blood/tracks,
/obj/effect/decal/cleanable/blood/footprints,
/obj/effect/decal/cleanable/blood,
/turf/open/floor/naturalstone,
/area/indoors/cave)
"z" = (
/obj/effect/decal/cleanable/blood/footprints,
/turf/open/floor/naturalstone,
/area/indoors/cave)
"A" = (
/obj/effect/decal/cleanable/blood/tracks{
	dir = 10
	},
/turf/open/floor/naturalstone,
/area/indoors/cave)
"C" = (
/obj/effect/decal/cleanable/blood/gibs/old,
/obj/effect/decal/cleanable/blood,
/turf/open/floor/naturalstone,
/area/indoors/cave)
"D" = (
/obj/machinery/light/fueled/firebowl,
/turf/open/floor/naturalstone,
/area/indoors/cave)
"F" = (
/obj/effect/decal/cleanable/blood/gibs/up,
/turf/open/floor/naturalstone,
/area/indoors/cave)
"I" = (
/obj/effect/decal/cleanable/blood/puddle,
/obj/effect/decal/cleanable/blood/old,
/obj/effect/decal/cleanable/blood/old,
/turf/open/floor/naturalstone,
/area/indoors/cave)
"J" = (
/obj/effect/decal/cleanable/blood/splatter,
/obj/effect/decal/cleanable/blood/old,
/turf/open/floor/naturalstone,
/area/indoors/cave)
"M" = (
/obj/effect/decal/cleanable/blood/tracks{
	dir = 4
	},
/turf/open/floor/naturalstone,
/area/indoors/cave)
"N" = (
/obj/effect/decal/cleanable/blood/splatter,
/obj/effect/decal/cleanable/blood/old,
/obj/effect/decal/cleanable/blood/gibs,
/turf/open/floor/naturalstone,
/area/indoors/cave)
"O" = (
/obj/effect/decal/cleanable/blood/gibs/old,
/turf/open/floor/naturalstone,
/area/indoors/cave)
"P" = (
/obj/effect/decal/cleanable/blood/gibs,
/turf/open/floor/naturalstone,
/area/indoors/cave)
"Q" = (
/obj/effect/decal/cleanable/blood/old,
/obj/effect/decal/cleanable/blood,
/turf/open/floor/naturalstone,
/area/indoors/cave)
"R" = (
/obj/effect/decal/cleanable/blood/footprints,
/obj/effect/decal/cleanable/blood/footprints{
	dir = 8
	},
/obj/machinery/light/fueled/firebowl,
/turf/open/floor/naturalstone,
/area/indoors/cave)
"S" = (
/obj/effect/decal/cleanable/blood/puddle,
/obj/effect/decal/cleanable/blood/old,
/turf/open/floor/naturalstone,
/area/indoors/cave)
"T" = (
/obj/effect/decal/cleanable/blood/tracks{
	dir = 5
	},
/turf/open/floor/naturalstone,
/area/indoors/cave)
"V" = (
/obj/effect/decal/cleanable/blood/puddle,
/turf/open/floor/naturalstone,
/area/indoors/cave)
"Y" = (
/obj/effect/decal/cleanable/blood/tracks{
	dir = 8
	},
/turf/open/floor/naturalstone,
/area/indoors/cave)

(1,1,1) = {"
u
u
u
u
u
u
u
u
u
u
u
u
a
a
a
a
a
u
u
u
u
u
u
u
u
"}
(2,1,1) = {"
u
u
u
u
u
u
u
u
u
u
u
u
a
a
t
a
a
u
u
u
u
u
u
u
u
"}
(3,1,1) = {"
u
u
a
a
a
a
a
a
a
a
a
c
a
a
R
a
a
a
a
a
f
f
a
a
u
"}
(4,1,1) = {"
u
u
a
a
a
a
a
a
a
a
a
a
a
a
v
a
a
a
c
a
f
a
a
a
u
"}
(5,1,1) = {"
u
u
a
f
a
a
a
Q
a
a
a
a
w
w
e
c
a
a
a
a
a
a
a
a
u
"}
(6,1,1) = {"
u
u
a
f
a
M
a
a
a
x
a
a
f
a
y
w
w
w
m
a
a
a
x
a
u
"}
(7,1,1) = {"
u
u
f
f
a
M
a
a
a
a
f
f
a
a
a
a
a
a
a
a
a
a
a
a
u
"}
(8,1,1) = {"
u
u
a
a
c
a
a
c
c
a
a
a
a
c
a
a
a
k
a
a
a
a
f
f
u
"}
(9,1,1) = {"
u
u
a
a
a
a
w
c
a
a
a
n
P
c
c
a
a
a
a
F
a
a
f
f
u
"}
(10,1,1) = {"
u
u
a
a
a
a
a
a
a
a
x
a
a
a
a
a
x
a
c
a
a
a
a
a
a
"}
(11,1,1) = {"
a
a
a
x
c
a
F
a
S
a
a
a
a
a
a
a
a
a
a
a
a
x
a
a
a
"}
(12,1,1) = {"
a
a
a
f
f
a
a
J
a
a
a
F
a
a
a
a
a
a
a
s
a
a
a
a
a
"}
(13,1,1) = {"
a
a
D
a
s
A
x
a
s
a
a
a
a
g
a
w
s
a
F
a
a
a
k
D
a
"}
(14,1,1) = {"
a
a
z
z
z
a
a
a
s
s
w
O
s
a
a
a
a
a
a
a
c
a
a
a
a
"}
(15,1,1) = {"
a
a
a
a
a
w
f
a
a
a
a
a
a
V
a
a
a
a
a
a
a
a
a
a
a
"}
(16,1,1) = {"
u
u
a
a
a
a
a
f
f
f
a
a
a
a
a
x
C
a
a
a
Y
a
a
a
a
"}
(17,1,1) = {"
u
u
a
f
a
a
a
a
V
N
a
a
a
a
c
a
a
a
a
a
Y
a
c
a
u
"}
(18,1,1) = {"
u
u
f
f
a
T
I
a
F
F
a
x
a
a
a
a
a
c
a
a
Y
a
a
a
u
"}
(19,1,1) = {"
u
u
a
f
a
a
a
a
a
a
x
a
F
a
a
F
x
a
a
a
M
a
a
f
u
"}
(20,1,1) = {"
u
u
a
a
h
a
a
h
a
c
a
c
a
a
s
a
a
a
a
a
M
a
a
f
u
"}
(21,1,1) = {"
u
u
a
h
a
a
a
f
a
a
a
a
V
a
c
a
c
a
a
s
a
a
a
a
u
"}
(22,1,1) = {"
u
u
a
a
a
a
a
f
f
f
a
a
a
a
D
a
a
c
a
a
a
a
a
a
u
"}
(23,1,1) = {"
u
u
u
u
u
u
u
u
u
u
u
u
a
a
a
a
a
u
u
u
u
u
u
u
u
"}
(24,1,1) = {"
u
u
u
u
u
u
u
u
u
u
u
u
a
a
a
a
a
u
u
u
u
u
u
u
u
"}
(25,1,1) = {"
u
u
u
u
u
u
u
u
u
u
u
u
a
a
a
a
a
u
u
u
u
u
u
u
u
"}
