//MAP CONVERTED BY dmm2tgm.py THIS HEADER COMMENT PREVENTS RECONVERSION, DO NOT REMOVE
"a" = (
/turf/open/floor/naturalstone,
/area/under/cave)
"c" = (
/obj/effect/decal/cleanable/blood/old,
/turf/open/floor/naturalstone,
/area/under/cave)
"d" = (
/obj/effect/decal/cleanable/blood/tracks{
	dir = 4
	},
/obj/effect/spawner/map_spawner/necropolis/water_tiles,
/turf/open/floor/naturalstone,
/area/under/cave)
"e" = (
/obj/effect/decal/cleanable/blood/footprints,
/obj/effect/decal/cleanable/blood,
/turf/open/floor/naturalstone,
/area/under/cave)
"f" = (
/turf/open/floor/dirt,
/area/under/cave)
"g" = (
/mob/living/carbon/human/species/goblin/npc/ambush/cave{
	name = "Sophie"
	},
/turf/open/floor/naturalstone,
/area/under/cave)
"h" = (
/obj/effect/decal/cleanable/blood/gibs/down,
/turf/open/floor/naturalstone,
/area/under/cave)
"k" = (
/obj/effect/decal/cleanable/blood/gibs/torso,
/obj/effect/spawner/map_spawner/necropolis/water_tiles,
/turf/open/floor/naturalstone,
/area/under/cave)
"l" = (
/obj/effect/landmark/map_load_mark/necropolis/z3_pillars,
/turf/open/floor/naturalstone,
/area/under/cave)
"m" = (
/obj/effect/decal/cleanable/blood/tracks,
/obj/effect/decal/cleanable/blood/tracks,
/obj/effect/spawner/map_spawner/necropolis/water_tiles,
/turf/open/floor/naturalstone,
/area/under/cave)
"n" = (
/obj/effect/decal/cleanable/blood/splatter,
/obj/effect/decal/cleanable/blood/gibs/up,
/turf/open/floor/naturalstone,
/area/under/cave)
"q" = (
/obj/effect/decal/cleanable/blood/puddle,
/obj/effect/spawner/map_spawner/necropolis/water_tiles,
/turf/open/floor/naturalstone,
/area/under/cave)
"r" = (
/obj/effect/decal/cleanable/blood/old,
/obj/effect/spawner/map_spawner/necropolis/water_tiles,
/turf/open/floor/naturalstone,
/area/under/cave)
"s" = (
/obj/effect/decal/cleanable/blood,
/turf/open/floor/naturalstone,
/area/under/cave)
"t" = (
/obj/effect/decal/cleanable/blood/footprints{
	dir = 1
	},
/turf/open/floor/naturalstone,
/area/under/cave)
"u" = (
/turf/closed/mineral,
/area/under/cave)
"v" = (
/obj/effect/decal/cleanable/blood/footprints{
	dir = 8
	},
/turf/open/floor/naturalstone,
/area/under/cave)
"w" = (
/obj/effect/decal/cleanable/blood/tracks,
/turf/open/floor/naturalstone,
/area/under/cave)
"x" = (
/obj/effect/decal/cleanable/blood/splatter,
/turf/open/floor/naturalstone,
/area/under/cave)
"y" = (
/obj/effect/decal/cleanable/blood/tracks,
/obj/effect/decal/cleanable/blood/footprints,
/obj/effect/decal/cleanable/blood,
/obj/effect/spawner/map_spawner/necropolis/water_tiles,
/turf/open/floor/naturalstone,
/area/under/cave)
"z" = (
/obj/effect/decal/cleanable/blood/footprints,
/turf/open/floor/naturalstone,
/area/under/cave)
"A" = (
/obj/effect/decal/cleanable/blood/tracks{
	dir = 10
	},
/turf/open/floor/naturalstone,
/area/under/cave)
"B" = (
/obj/effect/spawner/map_spawner/necropolis/water_tiles,
/turf/open/floor/naturalstone,
/area/under/cave)
"C" = (
/obj/effect/decal/cleanable/blood/gibs/old,
/obj/effect/decal/cleanable/blood,
/turf/open/floor/naturalstone,
/area/under/cave)
"D" = (
/obj/machinery/light/fueled/firebowl,
/turf/open/floor/naturalstone,
/area/under/cave)
"F" = (
/obj/effect/decal/cleanable/blood/gibs/up,
/turf/open/floor/naturalstone,
/area/under/cave)
"G" = (
/obj/effect/spawner/map_spawner/necropolis/water_tiles,
/turf/open/floor/dirt,
/area/under/cave)
"I" = (
/obj/effect/decal/cleanable/blood/puddle,
/obj/effect/decal/cleanable/blood/old,
/obj/effect/decal/cleanable/blood/old,
/obj/effect/spawner/map_spawner/necropolis/water_tiles,
/turf/open/floor/naturalstone,
/area/under/cave)
"J" = (
/obj/effect/decal/cleanable/blood/splatter,
/obj/effect/decal/cleanable/blood/old,
/turf/open/floor/naturalstone,
/area/under/cave)
"K" = (
/obj/effect/decal/cleanable/blood/gibs/torso,
/turf/open/floor/naturalstone,
/area/under/cave)
"M" = (
/obj/effect/decal/cleanable/blood/tracks{
	dir = 4
	},
/turf/open/floor/naturalstone,
/area/under/cave)
"N" = (
/obj/effect/decal/cleanable/blood/splatter,
/obj/effect/decal/cleanable/blood/old,
/obj/effect/decal/cleanable/blood/gibs,
/obj/effect/spawner/map_spawner/necropolis/water_tiles,
/turf/open/floor/naturalstone,
/area/under/cave)
"O" = (
/obj/effect/decal/cleanable/blood/gibs/old,
/turf/open/floor/naturalstone,
/area/under/cave)
"P" = (
/obj/effect/decal/cleanable/blood/gibs,
/turf/open/floor/naturalstone,
/area/under/cave)
"Q" = (
/obj/effect/decal/cleanable/blood/old,
/obj/effect/decal/cleanable/blood,
/obj/effect/spawner/map_spawner/necropolis/water_tiles,
/turf/open/floor/naturalstone,
/area/under/cave)
"R" = (
/obj/effect/decal/cleanable/blood/footprints,
/obj/effect/decal/cleanable/blood/footprints{
	dir = 8
	},
/obj/machinery/light/fueled/firebowl,
/turf/open/floor/naturalstone,
/area/under/cave)
"S" = (
/obj/effect/decal/cleanable/blood/puddle,
/obj/effect/decal/cleanable/blood/old,
/turf/open/floor/naturalstone,
/area/under/cave)
"T" = (
/obj/effect/decal/cleanable/blood/tracks{
	dir = 5
	},
/obj/effect/spawner/map_spawner/necropolis/water_tiles,
/turf/open/floor/naturalstone,
/area/under/cave)
"U" = (
/obj/effect/decal/cleanable/blood/tracks,
/obj/effect/spawner/map_spawner/necropolis/water_tiles,
/turf/open/floor/naturalstone,
/area/under/cave)
"V" = (
/obj/effect/decal/cleanable/blood/puddle,
/turf/open/floor/naturalstone,
/area/under/cave)
"X" = (
/obj/effect/decal/cleanable/blood/gibs/up,
/obj/effect/spawner/map_spawner/necropolis/water_tiles,
/turf/open/floor/naturalstone,
/area/under/cave)
"Y" = (
/obj/effect/decal/cleanable/blood/tracks{
	dir = 8
	},
/turf/open/floor/naturalstone,
/area/under/cave)

(1,1,1) = {"
u
u
u
u
u
u
u
u
u
u
u
u
a
a
a
a
l
u
u
u
u
u
u
u
u
"}
(2,1,1) = {"
u
u
u
u
u
u
u
u
u
u
u
u
a
a
t
a
a
u
u
u
u
u
u
u
u
"}
(3,1,1) = {"
u
u
a
a
a
a
a
a
a
a
a
c
a
a
R
a
a
a
a
a
f
f
a
a
u
"}
(4,1,1) = {"
u
u
a
a
a
l
a
a
B
a
a
a
a
a
v
a
a
a
c
a
f
a
a
a
u
"}
(5,1,1) = {"
u
u
a
f
a
a
a
Q
a
a
a
a
w
w
e
c
a
a
a
a
a
a
a
a
u
"}
(6,1,1) = {"
u
u
a
f
a
M
B
B
a
x
a
a
f
B
y
U
w
w
m
B
a
a
x
a
u
"}
(7,1,1) = {"
u
u
f
f
B
d
B
B
B
a
f
f
a
B
B
B
a
B
a
B
B
a
a
a
u
"}
(8,1,1) = {"
u
u
a
a
c
a
a
c
r
B
a
a
B
r
a
a
B
k
a
a
B
a
f
f
u
"}
(9,1,1) = {"
u
u
a
a
a
a
w
c
a
a
a
n
P
c
c
a
B
a
a
F
a
a
f
f
u
"}
(10,1,1) = {"
u
u
a
a
a
a
a
a
a
a
x
a
a
a
a
a
x
a
c
a
a
a
a
a
a
"}
(11,1,1) = {"
a
a
a
x
c
a
F
a
S
a
a
a
a
a
a
a
a
a
a
a
a
x
a
a
a
"}
(12,1,1) = {"
a
a
a
f
f
a
a
J
a
a
a
F
a
a
a
a
a
a
a
s
a
a
a
a
a
"}
(13,1,1) = {"
a
a
D
a
s
A
x
a
s
a
a
a
a
a
g
w
s
a
F
a
a
a
K
D
a
"}
(14,1,1) = {"
a
a
z
z
z
a
a
a
s
s
w
O
s
a
a
a
a
a
a
a
c
a
a
a
a
"}
(15,1,1) = {"
a
a
a
a
a
w
f
a
a
a
a
B
a
V
a
a
a
a
B
a
a
a
a
a
a
"}
(16,1,1) = {"
u
u
a
a
B
B
B
G
f
G
B
B
a
a
a
x
C
a
B
a
Y
a
a
a
a
"}
(17,1,1) = {"
u
u
a
f
B
B
B
B
q
N
a
a
a
a
c
a
a
a
B
B
Y
a
c
a
u
"}
(18,1,1) = {"
u
u
f
f
a
T
I
a
X
F
a
x
a
a
a
a
a
c
a
B
Y
a
a
a
u
"}
(19,1,1) = {"
u
u
a
f
a
a
a
a
B
a
x
a
F
a
a
F
x
a
a
B
M
a
a
f
u
"}
(20,1,1) = {"
u
u
a
a
h
a
a
h
B
r
B
c
a
a
s
a
a
a
a
a
M
a
l
f
u
"}
(21,1,1) = {"
u
u
a
h
a
a
a
f
a
a
a
a
V
a
c
a
c
a
a
s
a
a
a
a
u
"}
(22,1,1) = {"
u
u
a
a
a
a
a
f
f
f
a
a
a
a
D
a
l
c
a
a
a
a
a
a
u
"}
(23,1,1) = {"
u
u
u
u
u
u
u
u
u
u
u
u
a
a
a
a
a
u
u
u
u
u
u
u
u
"}
(24,1,1) = {"
u
u
u
u
u
u
u
u
u
u
u
u
a
a
a
a
a
u
u
u
u
u
u
u
u
"}
(25,1,1) = {"
u
u
u
u
u
u
u
u
u
u
u
u
a
a
a
a
a
u
u
u
u
u
u
u
u
"}
