//MAP CONVERTED BY dmm2tgm.py THIS HEADER COMMENT PREVENTS RECONVERSION, DO NOT REMOVE
"aa" = (
/obj/effect/spawner/map_spawner/sewerencounter,
/turf/open/floor/dirt/road,
/area/under/cave)
"bJ" = (
/obj/structure/fluff/railing/tall/palisade,
/turf/open/floor/dirt/road,
/area/under/cave)
"bM" = (
/obj/effect/decal/cleanable/blood/splatter,
/turf/open/floor/naturalstone,
/area/under/cave)
"cw" = (
/obj/structure/chair/wood/alt/chair_noble/fancyplush,
/turf/open/floor/dirt/road,
/area/under/cave)
"eB" = (
/obj/effect/decal/cleanable/blood/puddle,
/obj/effect/spawner/map_spawner/necropolis/mob_spawner/goblin,
/turf/open/floor/dirt/road,
/area/under/cave)
"eC" = (
/obj/effect/spawner/map_spawner/necropolis/mob_spawner/orcs,
/turf/open/floor/dirt/road,
/area/under/cave)
"gR" = (
/obj/effect/decal/cleanable/blood,
/obj/machinery/light/fueled/torchholder/r,
/turf/open/floor/naturalstone,
/area/under/cave)
"jC" = (
/obj/effect/decal/cleanable/blood/puddle,
/obj/effect/decal/cleanable/blood/old,
/obj/effect/decal/cleanable/blood/old,
/turf/open/floor/naturalstone,
/area/under/cave)
"jE" = (
/turf/closed/mineral,
/area/under/cave)
"jY" = (
/obj/item/weapon/polearm/spear,
/turf/open/floor/dirt/road,
/area/under/cave)
"kh" = (
/turf/open/floor/dirt,
/area/under/cave)
"ll" = (
/obj/structure/bed/hay,
/obj/machinery/light/fueled/torchholder/c,
/turf/open/floor/dirt/road,
/area/under/cave)
"lB" = (
/obj/effect/landmark/chest_or_mimic,
/obj/effect/spawner/map_spawner/loot/medium,
/obj/machinery/light/fueled/torchholder/c,
/turf/open/floor/dirt/road,
/area/under/cave)
"lF" = (
/obj/effect/decal/cleanable/blood/puddle,
/turf/open/floor/naturalstone,
/area/under/cave)
"lH" = (
/obj/effect/decal/cleanable/blood/puddle,
/obj/effect/mob_spawn/human/corpse,
/turf/open/floor/naturalstone,
/area/under/cave)
"lR" = (
/obj/effect/decal/cleanable/blood/gibs/torso,
/obj/effect/decal/cleanable/blood/old,
/turf/open/floor/naturalstone,
/area/under/cave)
"nm" = (
/obj/effect/decal/remains/human,
/turf/open/floor/naturalstone,
/area/under/cave)
"om" = (
/turf/open/floor/dirt/road,
/area/under/cave)
"oV" = (
/obj/structure/bed/hay,
/obj/effect/mob_spawn/human/corpse/damaged,
/obj/effect/spawner/map_spawner/necropolis/mob_spawner/goblin,
/turf/open/floor/dirt/road,
/area/under/cave)
"ps" = (
/obj/structure/bed/hay,
/obj/effect/mob_spawn/human/corpse/damaged,
/turf/open/floor/dirt/road,
/area/under/cave)
"qs" = (
/obj/effect/decal/cleanable/blood/tracks,
/obj/effect/decal/cleanable/blood/splatter,
/turf/open/floor/naturalstone,
/area/under/cave)
"qu" = (
/obj/structure/tent_wall,
/turf/open/floor/dirt/road,
/area/under/cave)
"rU" = (
/obj/effect/decal/cleanable/blood/gibs/core,
/turf/open/floor/naturalstone,
/area/under/cave)
"sl" = (
/obj/effect/landmark/map_load_mark/necropolis/z3_pillars,
/turf/closed/mineral,
/area/under/cave)
"tb" = (
/obj/effect/decal/cleanable/blood/footprints,
/turf/open/floor/naturalstone,
/area/under/cave)
"tF" = (
/obj/effect/decal/cleanable/blood/puddle,
/obj/effect/decal/cleanable/blood/puddle,
/turf/open/floor/naturalstone,
/area/under/cave)
"tU" = (
/obj/structure/bed/hay,
/turf/open/floor/dirt/road,
/area/under/cave)
"uG" = (
/obj/effect/decal/cleanable/blood/old,
/turf/open/floor/naturalstone,
/area/under/cave)
"uL" = (
/obj/effect/mob_spawn/human/corpse/damaged,
/obj/effect/spawner/map_spawner/necropolis/water_tiles,
/turf/open/floor/dirt/road,
/area/under/cave)
"uW" = (
/obj/item/bodypart/r_leg,
/turf/open/floor/naturalstone,
/area/under/cave)
"vk" = (
/obj/structure/tent_wall,
/obj/structure/tent_wall,
/obj/structure/tent_wall,
/turf/open/floor/naturalstone,
/area/under/cave)
"vJ" = (
/obj/structure/fluff/railing/tall/palisade,
/obj/structure/fluff/railing/tall/palisade,
/turf/open/floor/naturalstone,
/area/under/cave)
"vM" = (
/obj/effect/mob_spawn/human/corpse,
/turf/open/floor/dirt/road,
/area/under/cave)
"vR" = (
/obj/item/restraints/legcuffs/beartrap/armed/camouflage,
/turf/open/floor/dirt/road,
/area/under/cave)
"wc" = (
/obj/structure/tent_wall,
/obj/structure/tent_wall,
/turf/open/floor/naturalstone,
/area/under/cave)
"yf" = (
/obj/machinery/light/fueled/torchholder/l,
/turf/open/floor/naturalstone,
/area/under/cave)
"yt" = (
/obj/machinery/light/fueled/torchholder/c,
/turf/open/floor/naturalstone,
/area/under/cave)
"yH" = (
/obj/effect/decal/cleanable/blood/tracks{
	dir = 10
	},
/obj/effect/spawner/map_spawner/sewerencounter,
/turf/open/floor/naturalstone,
/area/under/cave)
"zP" = (
/obj/effect/decal/cleanable/blood,
/turf/open/floor/dirt/road,
/area/under/cave)
"AO" = (
/obj/structure/chair/stool/crafted,
/turf/open/floor/dirt/road,
/area/under/cave)
"BI" = (
/obj/effect/spawner/map_spawner/necropolis/mob_spawner/goblin,
/turf/open/floor/dirt,
/area/under/cave)
"El" = (
/obj/effect/decal/cleanable/blood/tracks{
	dir = 8
	},
/obj/machinery/light/fueled/firebowl,
/turf/open/floor/naturalstone,
/area/under/cave)
"Eo" = (
/obj/effect/decal/cleanable/blood/old,
/turf/open/floor/dirt/road,
/area/under/cave)
"Fl" = (
/obj/item/weapon/knife/dagger/steel,
/obj/structure/table/wood/crafted,
/turf/open/floor/dirt/road,
/area/under/cave)
"Gh" = (
/obj/effect/spawner/map_spawner/necropolis/water_tiles,
/turf/open/floor/naturalstone,
/area/under/cave)
"Gn" = (
/obj/machinery/light/fueled/torchholder/r,
/turf/open/floor/naturalstone,
/area/under/cave)
"GQ" = (
/obj/effect/decal/cleanable/blood/old,
/obj/machinery/light/fueled/torchholder/c,
/turf/open/floor/naturalstone,
/area/under/cave)
"Hi" = (
/obj/structure/bed/hay,
/obj/effect/decal/cleanable/blood/puddle,
/turf/open/floor/dirt/road,
/area/under/cave)
"HR" = (
/obj/structure/fluff/railing/tall/palisade,
/turf/open/floor/naturalstone,
/area/under/cave)
"IC" = (
/obj/item/bodypart/l_leg,
/turf/open/floor/dirt/road,
/area/under/cave)
"JD" = (
/obj/structure/rack/shelf/big,
/obj/effect/spawner/map_spawner/loot/weapon,
/obj/effect/spawner/map_spawner/loot/weapon,
/turf/open/floor/dirt/road,
/area/under/cave)
"Le" = (
/obj/effect/decal/cleanable/blood/old,
/obj/structure/fluff/railing/tall/palisade,
/turf/open/floor/dirt/road,
/area/under/cave)
"Ly" = (
/obj/effect/decal/cleanable/blood/puddle,
/obj/structure/fluff/railing/tall/palisade,
/turf/open/floor/naturalstone,
/area/under/cave)
"Ps" = (
/obj/structure/rack/shelf/big,
/obj/effect/spawner/map_spawner/loot/armor,
/obj/effect/spawner/map_spawner/loot/armor,
/turf/open/floor/dirt/road,
/area/under/cave)
"PE" = (
/obj/effect/decal/cleanable/blood/puddle,
/obj/effect/decal/cleanable/blood/tracks{
	dir = 8
	},
/turf/open/floor/dirt/road,
/area/under/cave)
"PQ" = (
/obj/effect/decal/cleanable/blood/splatter,
/turf/open/floor/dirt/road,
/area/under/cave)
"Qc" = (
/obj/structure/chair/stool/crafted,
/obj/effect/spawner/map_spawner/necropolis/mob_spawner/orcs,
/turf/open/floor/dirt/road,
/area/under/cave)
"Qd" = (
/obj/structure/tent_wall,
/turf/open/floor/naturalstone,
/area/under/cave)
"Rv" = (
/obj/effect/decal/cleanable/blood,
/turf/open/floor/naturalstone,
/area/under/cave)
"RB" = (
/obj/structure/roguetent,
/obj/effect/decal/cleanable/blood/tracks,
/turf/open/floor/dirt/road,
/area/under/cave)
"RW" = (
/obj/effect/spawner/map_spawner/necropolis/water_tiles,
/turf/open/floor/dirt/road,
/area/under/cave)
"TI" = (
/obj/structure/table/wood/crafted,
/turf/open/floor/dirt/road,
/area/under/cave)
"TX" = (
/obj/machinery/light/fueled/torchholder/c,
/obj/effect/spawner/map_spawner/sewerencounter,
/turf/open/floor/dirt/road,
/area/under/cave)
"WB" = (
/obj/effect/decal/cleanable/blood/puddle,
/obj/effect/decal/cleanable/blood/old,
/turf/open/floor/naturalstone,
/area/under/cave)
"WT" = (
/obj/effect/decal/cleanable/blood/gibs/old,
/obj/effect/decal/cleanable/blood/old,
/turf/open/floor/dirt/road,
/area/under/cave)
"Yh" = (
/obj/structure/roguetent,
/turf/open/floor/dirt/road,
/area/under/cave)
"Ys" = (
/turf/open/floor/naturalstone,
/area/under/cave)
"YU" = (
/obj/effect/spawner/map_spawner/sewerencounter,
/turf/open/floor/naturalstone,
/area/under/cave)
"Zn" = (
/obj/effect/decal/cleanable/blood/tracks,
/turf/open/floor/dirt/road,
/area/under/cave)

(1,1,1) = {"
jE
jE
jE
jE
jE
jE
jE
jE
Ys
Ys
Ys
Ys
om
Gh
Gh
jE
jE
jE
jE
jE
jE
jE
jE
jE
jE
"}
(2,1,1) = {"
jE
jE
jE
jE
jE
jE
jE
jE
Ys
jE
om
om
RW
RW
Ys
jE
jE
jE
jE
jE
jE
jE
jE
jE
jE
"}
(3,1,1) = {"
jE
jE
jE
jE
jE
sl
jE
jE
Ys
Ys
om
om
Ys
jE
jE
jE
jE
jE
jE
jE
jE
jE
jE
jE
jE
"}
(4,1,1) = {"
jE
jE
jE
jE
jE
jE
jE
jE
jE
jE
om
om
jE
jE
jE
jE
jE
jE
jE
jE
sl
jE
jE
jE
jE
"}
(5,1,1) = {"
jE
jE
jE
Ys
Ys
om
Ys
Ys
Ys
lF
om
om
om
Ys
Ys
Ys
Ys
jE
jE
jE
jE
jE
jE
jE
jE
"}
(6,1,1) = {"
jE
jE
jE
om
om
Ys
HR
Ys
Ys
gR
om
zP
HR
Ys
om
Ys
Gh
Gh
jE
jE
jE
jE
jE
jE
jE
"}
(7,1,1) = {"
jE
jE
jE
Ys
YU
Ys
Qd
Qd
Qd
Qd
wc
Qd
Qd
yt
lF
rU
om
Gh
Gh
jE
jE
jE
jE
jE
jE
"}
(8,1,1) = {"
jE
jE
jE
Ys
Ys
Ys
Qd
Hi
om
JD
Ps
ps
Qd
Ys
lF
Ys
aa
RW
om
jE
jE
jE
jE
jE
jE
"}
(9,1,1) = {"
jE
Ys
jE
lF
Ys
lF
Qd
ll
om
eB
om
ll
Qd
Ys
tb
tb
tb
uL
RW
Ys
jE
jE
jE
jE
Ys
"}
(10,1,1) = {"
jE
Ys
Ys
Ys
om
Ys
Qd
oV
aa
om
eB
tU
wc
Ys
lF
Ys
Rv
RW
RW
jE
jE
jE
jE
jE
Ys
"}
(11,1,1) = {"
Ys
Gh
Ys
om
om
Ys
Qd
Qd
Qd
Qd
Yh
Qd
Qd
GQ
jC
om
om
Ys
Ys
jE
jE
Ys
Ys
Ys
Gh
"}
(12,1,1) = {"
RW
RW
om
om
Ys
Ys
bJ
Ys
Ys
Ys
Ys
Ys
uW
Ys
lH
om
om
HR
om
jE
jE
Gh
RW
Gh
Gh
"}
(13,1,1) = {"
RW
om
zP
Ys
lF
om
Ly
Ys
vR
Ys
yH
uG
Ys
WB
Ys
Gn
Rv
vJ
Ys
jE
jE
RW
RW
Gh
Ys
"}
(14,1,1) = {"
RW
om
Ys
Gn
tF
om
om
Ys
Ys
nm
El
om
Ys
Qd
Qd
Qd
Qd
Qd
Ys
om
jE
om
om
om
om
"}
(15,1,1) = {"
om
Ys
jE
Qd
Qd
Qd
Qd
Qd
Qd
GQ
PE
om
Ys
wc
kh
kh
om
wc
Ys
Ys
Ys
om
om
om
om
"}
(16,1,1) = {"
Ys
Ys
jE
lB
TI
om
Qc
aa
Qd
Ys
Eo
jY
Ys
Qd
om
BI
kh
Qd
Ys
Ys
Ys
om
Ys
om
om
"}
(17,1,1) = {"
Ys
Ys
jE
cw
Fl
om
AO
om
Qd
bM
lR
vM
Ys
Yh
kh
kh
BI
Qd
yt
Ys
Ys
jE
Ys
Ys
Ys
"}
(18,1,1) = {"
Ys
jE
jE
PQ
TI
eC
AO
Zn
RB
qs
WT
Ys
YU
wc
kh
om
kh
Qd
Ys
Ys
jE
jE
Ys
jE
Ys
"}
(19,1,1) = {"
jE
jE
jE
TX
om
Eo
IC
om
Qd
bM
bM
Eo
Ys
vk
Qd
Qd
Qd
Qd
Ys
om
jE
jE
jE
jE
jE
"}
(20,1,1) = {"
jE
jE
jE
qu
Qd
Qd
Qd
Qd
Qd
yt
Le
om
Ys
HR
Ys
yf
Ys
HR
Ys
om
jE
jE
jE
sl
jE
"}
(21,1,1) = {"
jE
jE
jE
Ys
Ys
Ys
bM
uG
Ys
Ys
HR
Ys
Ys
om
om
Ys
Ys
Ys
om
aa
jE
jE
jE
jE
jE
"}
(22,1,1) = {"
jE
jE
jE
sl
jE
jE
jE
jE
jE
jE
jE
Ys
Ys
om
jE
jE
jE
jE
jE
jE
jE
jE
jE
jE
jE
"}
(23,1,1) = {"
jE
jE
jE
jE
jE
jE
jE
jE
jE
Ys
Ys
om
om
jE
jE
jE
jE
jE
jE
jE
jE
jE
jE
jE
jE
"}
(24,1,1) = {"
jE
jE
jE
jE
jE
jE
jE
jE
jE
jE
jE
om
RW
om
jE
jE
jE
jE
jE
jE
jE
jE
jE
jE
jE
"}
(25,1,1) = {"
jE
jE
jE
jE
jE
jE
jE
jE
jE
Ys
Ys
RW
RW
RW
Gh
Gh
jE
jE
jE
jE
jE
jE
jE
jE
jE
"}
