//MAP CONVERTED BY dmm2tgm.py THIS HEADER COMMENT PREVENTS RECONVERSION, DO NOT REMOVE
"a" = (
/turf/closed/mineral,
/area/under/cave)
"b" = (
/obj/effect/decal/cleanable/dirt/cobweb,
/turf/open/floor/naturalstone,
/area/under/cave)
"c" = (
/obj/effect/spawner/map_spawner/necropolis/random_dirty,
/obj/effect/spawner/map_spawner/necropolis/random_rock_wall,
/turf/open/floor/naturalstone,
/area/under/cave)
"e" = (
/mob/living/simple_animal/hostile/retaliate/spider,
/turf/open/floor/naturalstone,
/area/under/cave)
"o" = (
/obj/structure/spider/stickyweb,
/mob/living/simple_animal/hostile/retaliate/spider,
/turf/open/floor/naturalstone,
/area/under/cave)
"q" = (
/turf/open/floor/naturalstone,
/area/under/cave)
"r" = (
/obj/structure/spider/stickyweb,
/obj/effect/spawner/map_spawner/loot,
/turf/open/floor/naturalstone,
/area/under/cave)
"t" = (
/obj/structure/spider/stickyweb,
/turf/open/floor/naturalstone,
/area/under/cave)
"u" = (
/obj/effect/spawner/map_spawner/necropolis/random_dirty,
/turf/open/floor/naturalstone,
/area/under/cave)
"C" = (
/obj/effect/spawner/map_spawner/necropolis/random_rock_wall,
/turf/open/floor/naturalstone,
/area/under/cave)
"E" = (
/obj/effect/spawner/map_spawner/necropolis,
/turf/open/floor/naturalstone,
/area/under/cave)
"J" = (
/obj/effect/decal/cleanable/dirt/cobweb/cobweb2,
/turf/open/floor/naturalstone,
/area/under/cave)
"Q" = (
/obj/effect/spawner/map_spawner/loot,
/turf/open/floor/naturalstone,
/area/under/cave)
"Z" = (
/obj/effect/spawner/map_spawner/necropolis/water_tiles,
/turf/open/floor/naturalstone,
/area/under/cave)

(1,1,1) = {"
a
a
a
q
q
a
a
a
a
q
q
C
q
q
q
C
a
a
a
a
a
a
q
Q
q
"}
(2,1,1) = {"
a
a
a
q
q
q
a
a
a
a
a
a
t
q
q
a
a
a
a
a
a
a
o
t
Q
"}
(3,1,1) = {"
a
a
a
q
t
q
a
a
a
a
a
a
a
a
q
q
q
a
a
a
a
q
t
t
e
"}
(4,1,1) = {"
a
a
a
q
t
q
a
a
a
a
a
a
a
a
a
u
E
a
a
a
q
t
t
q
q
"}
(5,1,1) = {"
a
a
a
a
q
q
q
q
a
a
a
a
a
b
q
q
q
a
q
q
t
q
a
a
a
"}
(6,1,1) = {"
a
a
a
a
a
a
q
q
t
q
a
a
b
t
q
a
a
a
a
q
t
q
a
a
a
"}
(7,1,1) = {"
a
a
b
q
r
t
a
a
q
t
a
t
t
q
a
a
a
q
q
q
q
q
a
a
a
"}
(8,1,1) = {"
a
q
t
q
t
t
a
a
q
C
e
q
q
q
q
a
a
t
a
a
q
E
a
a
a
"}
(9,1,1) = {"
a
t
q
a
a
q
a
a
a
a
q
q
a
t
t
a
a
q
a
a
q
q
a
a
a
"}
(10,1,1) = {"
a
t
t
a
a
q
a
a
q
t
t
a
a
q
t
a
a
q
a
a
q
q
a
a
a
"}
(11,1,1) = {"
q
q
q
a
a
q
q
a
q
u
q
a
a
r
t
q
q
t
a
a
q
q
a
a
q
"}
(12,1,1) = {"
q
q
J
a
a
q
r
q
t
q
a
q
q
t
t
q
t
q
a
a
q
a
a
a
q
"}
(13,1,1) = {"
q
a
a
a
a
E
q
q
t
t
q
e
q
q
q
q
q
a
a
a
q
a
a
a
q
"}
(14,1,1) = {"
q
a
a
a
a
a
J
e
a
r
q
q
a
a
a
q
a
a
a
a
q
q
C
c
Z
"}
(15,1,1) = {"
C
a
q
a
a
a
a
a
a
q
q
Z
Z
q
a
q
a
a
a
a
a
u
C
Z
Z
"}
(16,1,1) = {"
q
Z
Z
q
a
a
a
a
a
a
a
a
q
Z
a
t
t
e
a
a
a
q
a
Z
Z
"}
(17,1,1) = {"
a
Z
q
e
a
a
a
a
a
Q
t
t
u
q
a
t
t
q
a
a
a
a
a
a
q
"}
(18,1,1) = {"
a
q
q
t
a
a
a
a
a
t
q
q
a
a
a
q
t
q
a
a
a
a
a
a
q
"}
(19,1,1) = {"
a
a
a
t
t
a
a
a
a
e
q
a
a
a
a
q
q
a
a
a
a
a
a
a
a
"}
(20,1,1) = {"
a
a
t
r
t
a
a
a
a
q
q
a
a
q
a
q
q
a
a
a
a
a
a
a
a
"}
(21,1,1) = {"
a
a
q
t
q
q
t
t
q
Z
Z
Z
q
t
a
a
q
a
a
a
a
a
a
a
a
"}
(22,1,1) = {"
a
a
q
q
q
t
t
t
t
t
t
t
Z
Z
Z
a
t
q
a
a
a
a
a
a
a
"}
(23,1,1) = {"
a
a
a
q
Q
q
a
a
a
Q
a
a
a
q
q
q
t
t
a
a
a
a
a
a
a
"}
(24,1,1) = {"
a
a
a
a
a
a
a
a
a
a
a
a
a
a
q
t
q
t
a
a
a
a
a
a
a
"}
(25,1,1) = {"
a
a
a
a
a
a
a
a
a
a
a
q
q
q
q
q
q
a
a
a
a
a
a
a
a
"}
