//MAP CONVERTED BY dmm2tgm.py THIS HEADER COMMENT PREVENTS RECONVERSION, DO NOT REMOVE
"bD" = (
/obj/effect/decal/cleanable/dirt,
/obj/effect/landmark/map_load_mark/necropolis/z3_pillars,
/turf/open/floor/churchbrick,
/area/under/cave)
"bZ" = (
/obj/effect/decal/cleanable/dirt,
/obj/effect/decal/cleanable/dirt,
/obj/structure/chair/bench/church/smallbench/stone,
/turf/open/floor/churchbrick,
/area/under/cave)
"dy" = (
/obj/effect/decal/cleanable/dirt,
/obj/effect/decal/cleanable/dirt,
/turf/open/floor/churchbrick,
/area/under/cave)
"fg" = (
/obj/effect/spawner/map_spawner/necropolis,
/turf/open/floor/churchbrick,
/area/under/cave)
"fQ" = (
/obj/structure/bars/bent,
/turf/open/water/river{
	dir = 8
	},
/area/under/cave)
"gR" = (
/turf/open/floor/tile/bath,
/area/under/cave)
"ht" = (
/obj/structure/flora/pillar,
/turf/open/floor/churchbrick,
/area/under/cave)
"hC" = (
/turf/open/water/river{
	dir = 4
	},
/area/under/cave)
"iW" = (
/obj/structure/bars/alt,
/turf/open/water/river{
	dir = 8
	},
/area/under/cave)
"ja" = (
/obj/effect/decal/cleanable/dirt,
/obj/structure/flora/pillar,
/turf/open/floor/tile/bath,
/area/under/cave)
"jK" = (
/obj/effect/decal/cleanable/dirt,
/turf/closed/mineral,
/area/under/cave)
"kA" = (
/obj/structure/bars/bent,
/turf/open/water/river{
	dir = 4
	},
/area/under/cave)
"mk" = (
/obj/effect/decal/cleanable/dirt,
/obj/effect/spawner/map_spawner/necropolis,
/turf/open/floor/churchbrick,
/area/under/cave)
"mp" = (
/obj/effect/decal/cleanable/dirt,
/obj/item/chair/chair3,
/turf/open/floor/churchbrick,
/area/under/cave)
"pe" = (
/turf/open/water/river{
	dir = 1
	},
/area/under/cave)
"pj" = (
/obj/effect/decal/cleanable/dirt,
/obj/effect/decal/cleanable/dirt,
/obj/effect/landmark/map_load_mark/necropolis/z3_pillars,
/turf/open/floor/churchbrick,
/area/under/cave)
"ry" = (
/obj/structure/chair/bench,
/turf/open/floor/tile/bath,
/area/under/cave)
"tt" = (
/obj/effect/spawner/map_spawner/necropolis/shroom_clutter,
/turf/open/floor/tile/bath,
/area/under/cave)
"tR" = (
/obj/effect/decal/cleanable/dirt,
/obj/effect/decal/cleanable/dirt,
/obj/effect/spawner/map_spawner/necropolis,
/turf/open/floor/churchbrick,
/area/under/cave)
"uC" = (
/turf/open/water/river{
	dir = 8
	},
/area/under/cave)
"uG" = (
/turf/open/floor/churchbrick,
/area/under/cave)
"vz" = (
/obj/effect/decal/cleanable/dirt,
/obj/effect/decal/cleanable/dirt,
/obj/effect/spawner/map_spawner/necropolis/shroom_clutter,
/turf/open/floor/churchbrick,
/area/under/cave)
"vZ" = (
/obj/effect/decal/cleanable/dirt,
/obj/item/natural/rock,
/turf/open/floor/churchbrick,
/area/under/cave)
"wc" = (
/turf/closed/mineral,
/area/under/cave)
"xJ" = (
/obj/structure/bars,
/turf/open/water/river,
/area/under/cave)
"xY" = (
/obj/effect/decal/cleanable/dirt,
/turf/open/floor/churchbrick,
/area/under/cave)
"yH" = (
/obj/effect/decal/cleanable/dirt,
/obj/effect/decal/cleanable/dirt,
/obj/effect/decal/cleanable/dirt,
/turf/open/floor/tile/bath,
/area/under/cave)
"Af" = (
/obj/item/chair/chair3,
/turf/open/floor/churchbrick,
/area/under/cave)
"AU" = (
/obj/effect/spawner/map_spawner/necropolis,
/turf/open/floor/tile/bath,
/area/under/cave)
"Ed" = (
/obj/effect/spawner/map_spawner/necropolis,
/turf/open/floor/dirt,
/area/under/cave)
"Ef" = (
/obj/effect/decal/cleanable/dirt,
/obj/effect/decal/cleanable/dirt,
/obj/effect/decal/cleanable/dirt,
/obj/item/natural/rock,
/turf/open/floor/churchbrick,
/area/under/cave)
"Ep" = (
/obj/structure/flora/pillar,
/turf/open/floor/tile/bath,
/area/under/cave)
"Fd" = (
/obj/effect/decal/cleanable/dirt,
/obj/effect/spawner/map_spawner/necropolis,
/turf/open/floor/tile/bath,
/area/under/cave)
"FX" = (
/obj/effect/decal/cleanable/dirt,
/obj/item/natural/rock,
/turf/open/floor/tile/bath,
/area/under/cave)
"Gu" = (
/obj/effect/decal/cleanable/dirt,
/obj/effect/decal/cleanable/dirt,
/obj/item/natural/rock,
/turf/open/floor/tile/bath,
/area/under/cave)
"IN" = (
/obj/effect/spawner/map_spawner/necropolis/shroom_clutter,
/turf/open/floor/naturalstone,
/area/under/cave)
"IY" = (
/obj/structure/bars,
/turf/open/water/river{
	dir = 1
	},
/area/under/cave)
"MH" = (
/turf/open/floor/naturalstone,
/area/under/cave)
"Nw" = (
/obj/structure/bars,
/turf/open/water/river{
	dir = 8
	},
/area/under/cave)
"OA" = (
/obj/effect/decal/cleanable/dirt,
/obj/effect/decal/cleanable/dirt,
/obj/effect/spawner/map_spawner/necropolis/shroom_clutter,
/turf/open/floor/tile/bath,
/area/under/cave)
"PV" = (
/obj/effect/decal/cleanable/dirt,
/obj/effect/decal/cleanable/dirt,
/obj/structure/flora/pillar,
/turf/open/floor/tile/bath,
/area/under/cave)
"PX" = (
/turf/open/water/river,
/area/under/cave)
"Qf" = (
/obj/structure/bars/bent,
/turf/open/water/river,
/area/under/cave)
"QA" = (
/obj/effect/spawner/map_spawner/necropolis,
/turf/open/floor/naturalstone,
/area/under/cave)
"Re" = (
/obj/effect/spawner/map_spawner/necropolis/shroom_clutter,
/turf/open/floor/dirt,
/area/under/cave)
"Rh" = (
/obj/structure/chair/bench/church/smallbench/stone,
/turf/open/floor/churchbrick,
/area/under/cave)
"Ru" = (
/obj/structure/bars/bent,
/turf/open/water/river{
	dir = 1
	},
/area/under/cave)
"Ss" = (
/obj/effect/decal/cleanable/dirt,
/obj/effect/decal/cleanable/dirt,
/turf/open/floor/tile/bath,
/area/under/cave)
"SF" = (
/obj/effect/landmark/map_load_mark/necropolis/z3_pillars,
/turf/open/floor/dirt,
/area/under/cave)
"TA" = (
/obj/effect/decal/cleanable/dirt,
/obj/effect/decal/cleanable/dirt,
/obj/structure/chair/bench,
/turf/open/floor/tile/bath,
/area/under/cave)
"UG" = (
/obj/effect/decal/cleanable/dirt,
/turf/open/floor/tile/bath,
/area/under/cave)
"Vu" = (
/obj/structure/bars,
/turf/open/water/river{
	dir = 4
	},
/area/under/cave)
"Wq" = (
/obj/effect/decal/cleanable/dirt,
/obj/effect/decal/cleanable/dirt,
/obj/effect/spawner/map_spawner/necropolis,
/turf/open/floor/tile/bath,
/area/under/cave)
"Wz" = (
/obj/effect/decal/cleanable/dirt,
/obj/structure/flora/pillar,
/turf/open/floor/churchbrick,
/area/under/cave)
"WV" = (
/obj/effect/landmark/map_load_mark/necropolis/z3_pillars,
/turf/open/floor/churchbrick,
/area/under/cave)
"XA" = (
/obj/effect/spawner/map_spawner/necropolis/shroom_clutter,
/turf/open/floor/churchbrick,
/area/under/cave)
"XY" = (
/turf/open/floor/dirt,
/area/under/cave)
"Yp" = (
/obj/item/natural/rock,
/turf/open/floor/churchbrick,
/area/under/cave)
"Zo" = (
/obj/item/natural/rock,
/turf/open/floor/tile/bath,
/area/under/cave)

(1,1,1) = {"
wc
wc
wc
wc
wc
wc
wc
wc
wc
wc
xJ
xJ
Vu
Vu
Vu
IY
wc
wc
wc
wc
wc
wc
wc
wc
wc
"}
(2,1,1) = {"
wc
wc
wc
gR
uG
uG
uG
uG
gR
gR
gR
PX
hC
hC
hC
pe
gR
uG
fg
uG
xY
xY
jK
jK
wc
"}
(3,1,1) = {"
wc
Ss
TA
xY
mk
xY
xY
uG
uG
gR
gR
PX
hC
hC
hC
pe
pe
uG
xY
xY
uG
ht
uG
gR
wc
"}
(4,1,1) = {"
wc
gR
UG
xY
xY
xY
dy
Wz
xY
gR
UG
PX
hC
hC
hC
pe
pe
xY
Ef
dy
bD
uG
uG
gR
wc
"}
(5,1,1) = {"
wc
gR
xY
vZ
dy
dy
pj
xY
dy
xY
gR
PX
hC
hC
hC
pe
gR
xY
dy
xY
uG
uG
uG
gR
wc
"}
(6,1,1) = {"
wc
gR
vz
uG
xY
xY
Yp
Yp
xY
xY
gR
PX
hC
hC
hC
pe
ry
xY
Wz
uG
XA
Yp
xY
gR
wc
"}
(7,1,1) = {"
wc
gR
dy
uG
xY
dy
xY
fg
xY
xY
gR
PX
hC
hC
hC
pe
gR
xY
xY
uG
Af
uG
mk
gR
wc
"}
(8,1,1) = {"
wc
gR
PV
xY
uG
tR
dy
uG
xY
UG
gR
PX
hC
hC
hC
pe
pe
uG
Yp
uG
xY
xY
uG
gR
wc
"}
(9,1,1) = {"
wc
gR
gR
uG
uG
xY
dy
Rh
dy
Ss
PX
PX
hC
hC
hC
pe
gR
uG
uG
uG
uG
uG
uG
gR
wc
"}
(10,1,1) = {"
Vu
hC
hC
gR
uG
XA
dy
dy
Ss
gR
gR
PX
hC
hC
hC
pe
hC
hC
hC
hC
hC
hC
hC
hC
kA
"}
(11,1,1) = {"
xJ
PX
hC
gR
gR
hC
Ss
Ss
Ss
gR
PX
hC
hC
hC
hC
hC
pe
pe
pe
pe
pe
pe
pe
pe
IY
"}
(12,1,1) = {"
Qf
PX
hC
hC
hC
hC
hC
hC
hC
hC
PX
PX
XY
Ed
SF
pe
pe
pe
pe
pe
pe
pe
pe
pe
pe
"}
(13,1,1) = {"
Qf
PX
PX
PX
PX
PX
PX
PX
PX
PX
PX
XY
MH
Re
XY
XY
pe
pe
pe
pe
pe
pe
pe
pe
Ru
"}
(14,1,1) = {"
Qf
PX
PX
PX
PX
PX
PX
PX
PX
PX
PX
MH
IN
QA
XY
Ed
pe
pe
pe
pe
pe
pe
pe
pe
Ru
"}
(15,1,1) = {"
xJ
PX
PX
PX
PX
PX
PX
PX
PX
PX
PX
uC
MH
MH
Re
pe
pe
pe
pe
pe
pe
pe
pe
pe
Ru
"}
(16,1,1) = {"
Nw
gR
uC
uG
uC
uC
uC
uC
uC
uG
PX
uC
uC
uC
uC
uC
pe
pe
pe
uC
uC
uG
uC
uC
iW
"}
(17,1,1) = {"
wc
gR
xY
uG
uG
gR
uC
gR
Yp
uG
uG
gR
PX
uC
uC
pe
gR
uC
uC
uC
uG
Yp
uC
uC
fQ
"}
(18,1,1) = {"
wc
gR
Ss
uG
vZ
xY
UG
xY
xY
uG
UG
gR
PX
uC
uC
pe
UG
AU
gR
uG
uG
uG
gR
gR
wc
"}
(19,1,1) = {"
wc
FX
Wq
gR
xY
xY
dy
dy
dy
gR
Fd
gR
PX
uC
uC
pe
Ss
Ss
Yp
uG
WV
uG
tt
gR
wc
"}
(20,1,1) = {"
wc
UG
yH
ja
UG
xY
pj
dy
Ss
Ep
gR
PX
PX
uC
uC
pe
gR
xY
uG
uG
uG
uG
gR
Ep
wc
"}
(21,1,1) = {"
wc
gR
yH
UG
OA
xY
xY
xY
dy
gR
UG
PX
PX
uC
uC
pe
pe
gR
mp
uG
xY
Yp
gR
gR
wc
"}
(22,1,1) = {"
jK
gR
UG
uG
bZ
xY
UG
vZ
xY
uG
UG
gR
PX
uC
uC
pe
UG
UG
gR
uG
XA
uG
gR
AU
wc
"}
(23,1,1) = {"
wc
wc
xY
xY
xY
gR
gR
gR
XA
xY
uG
gR
PX
uC
uC
pe
pe
UG
Gu
UG
uG
uG
Zo
wc
wc
"}
(24,1,1) = {"
wc
wc
wc
uG
gR
AU
Zo
UG
UG
xY
gR
gR
PX
uC
uC
pe
UG
UG
UG
ja
Ss
xY
wc
wc
wc
"}
(25,1,1) = {"
wc
wc
wc
wc
wc
wc
wc
wc
wc
wc
wc
xJ
xJ
uC
Nw
IY
wc
wc
wc
wc
wc
wc
wc
wc
wc
"}
