//MAP CONVERTED BY dmm2tgm.py THIS HEADER COMMENT PREVENTS RECONVERSION, DO NOT REMOVE
"a" = (
/turf/open/floor/churchbrick,
/area/indoors/cave)
"b" = (
/turf/open/openspace,
/area/indoors/cave)
"c" = (
/obj/effect/decal/cleanable/dirt,
/obj/effect/decal/cleanable/dirt,
/obj/item/natural/rock,
/turf/open/floor/tile/bath,
/area/indoors/cave)
"d" = (
/obj/effect/decal/cleanable/dirt,
/obj/item/natural/rock,
/turf/open/floor/tile/bath,
/area/indoors/cave)
"f" = (
/obj/effect/decal/cleanable/dirt,
/obj/structure/flora/pillar,
/turf/open/floor/tile/bath,
/area/indoors/cave)
"g" = (
/turf/closed/mineral,
/area/indoors/cave)
"i" = (
/obj/structure/flora/pillar,
/turf/open/floor/churchbrick,
/area/indoors/cave)
"j" = (
/turf/open/water/river,
/area/indoors/cave)
"k" = (
/obj/effect/decal/cleanable/dirt,
/turf/open/floor/tile/bath,
/area/indoors/cave)
"l" = (
/obj/structure/chair/bench,
/turf/open/floor/tile/bath,
/area/indoors/cave)
"n" = (
/turf/open/water/river{
	dir = 1
	},
/area/indoors/cave)
"o" = (
/turf/open/water/river{
	dir = 8
	},
/area/indoors/cave)
"p" = (
/obj/effect/decal/cleanable/dirt,
/obj/effect/decal/cleanable/dirt,
/obj/effect/decal/cleanable/dirt,
/turf/open/floor/tile/bath,
/area/indoors/cave)
"s" = (
/obj/structure/flora/pillar,
/turf/open/floor/tile/bath,
/area/indoors/cave)
"t" = (
/obj/effect/decal/cleanable/dirt,
/turf/closed/mineral,
/area/indoors/cave)
"u" = (
/obj/effect/decal/cleanable/dirt,
/obj/item/chair/chair3,
/turf/open/floor/churchbrick,
/area/indoors/cave)
"v" = (
/obj/structure/chair/bench/church/smallbench/stone,
/turf/open/floor/churchbrick,
/area/indoors/cave)
"x" = (
/obj/effect/decal/cleanable/dirt,
/obj/effect/decal/cleanable/dirt,
/obj/structure/flora/pillar,
/turf/open/floor/tile/bath,
/area/indoors/cave)
"y" = (
/obj/effect/decal/cleanable/dirt,
/obj/effect/decal/cleanable/dirt,
/obj/structure/chair/bench,
/turf/open/floor/tile/bath,
/area/indoors/cave)
"z" = (
/obj/effect/decal/cleanable/dirt,
/obj/effect/decal/cleanable/dirt,
/turf/open/floor/churchbrick,
/area/indoors/cave)
"B" = (
/obj/item/natural/rock,
/turf/open/floor/churchbrick,
/area/indoors/cave)
"G" = (
/obj/effect/decal/cleanable/dirt,
/turf/open/floor/churchbrick,
/area/indoors/cave)
"H" = (
/obj/effect/decal/cleanable/dirt,
/obj/item/natural/rock,
/turf/open/floor/churchbrick,
/area/indoors/cave)
"M" = (
/obj/effect/decal/cleanable/dirt,
/obj/structure/flora/pillar,
/turf/open/floor/churchbrick,
/area/indoors/cave)
"O" = (
/turf/open/floor/tile/bath,
/area/indoors/cave)
"P" = (
/obj/effect/decal/cleanable/dirt,
/obj/effect/decal/cleanable/dirt,
/turf/open/floor/tile/bath,
/area/indoors/cave)
"R" = (
/turf/open/water/river{
	dir = 4
	},
/area/indoors/cave)
"T" = (
/obj/item/chair/chair3,
/turf/open/floor/churchbrick,
/area/indoors/cave)
"U" = (
/obj/effect/decal/cleanable/dirt,
/obj/effect/decal/cleanable/dirt,
/obj/structure/chair/bench/church/smallbench/stone,
/turf/open/floor/churchbrick,
/area/indoors/cave)
"V" = (
/obj/effect/decal/cleanable/dirt,
/obj/effect/decal/cleanable/dirt,
/obj/effect/decal/cleanable/dirt,
/obj/item/natural/rock,
/turf/open/floor/churchbrick,
/area/indoors/cave)
"Y" = (
/obj/item/natural/rock,
/turf/open/floor/tile/bath,
/area/indoors/cave)

(1,1,1) = {"
g
g
g
g
g
g
g
g
g
g
j
j
R
R
R
n
g
g
g
g
g
g
g
g
g
"}
(2,1,1) = {"
g
O
O
O
a
a
a
a
O
O
O
j
R
R
R
n
O
a
a
a
G
G
G
k
g
"}
(3,1,1) = {"
g
P
y
G
G
G
G
a
a
O
O
j
R
R
R
n
n
a
G
G
a
i
a
O
g
"}
(4,1,1) = {"
g
O
k
G
G
G
z
M
G
O
k
j
R
R
R
n
n
G
V
z
G
a
a
O
g
"}
(5,1,1) = {"
g
O
G
H
z
z
z
G
z
G
O
j
R
R
R
n
O
G
z
G
a
a
a
O
g
"}
(6,1,1) = {"
g
O
z
a
G
G
B
B
G
G
O
j
R
R
R
n
l
G
M
a
a
B
G
O
g
"}
(7,1,1) = {"
g
O
z
a
G
z
G
a
G
G
O
j
R
R
R
n
O
G
G
a
T
a
G
O
g
"}
(8,1,1) = {"
g
O
x
G
a
z
z
a
G
k
O
j
R
R
R
n
n
a
B
a
G
G
a
O
g
"}
(9,1,1) = {"
g
O
O
a
a
G
z
v
z
P
j
j
R
R
R
n
O
a
a
a
a
a
a
O
g
"}
(10,1,1) = {"
R
R
R
O
a
a
z
z
P
O
O
j
R
R
R
n
R
R
R
R
R
R
R
R
R
"}
(11,1,1) = {"
j
j
R
O
O
R
P
P
P
O
j
R
R
R
R
R
n
n
n
n
n
n
n
n
n
"}
(12,1,1) = {"
j
j
R
R
R
R
R
R
R
R
j
b
b
b
b
b
n
n
n
n
n
n
n
n
n
"}
(13,1,1) = {"
j
j
j
j
j
j
j
j
j
j
j
b
b
b
b
b
n
n
n
n
n
n
n
n
n
"}
(14,1,1) = {"
j
j
j
j
j
j
j
j
j
j
j
b
b
b
b
b
n
n
n
n
n
n
n
n
n
"}
(15,1,1) = {"
j
j
j
j
j
j
j
j
j
j
j
b
b
b
b
b
n
n
n
n
n
n
n
n
n
"}
(16,1,1) = {"
o
O
o
a
o
o
o
o
o
a
j
o
o
o
o
o
n
n
n
o
o
a
o
o
o
"}
(17,1,1) = {"
g
O
G
a
a
O
o
O
B
a
a
O
j
o
o
n
O
o
o
o
a
B
o
o
o
"}
(18,1,1) = {"
g
O
P
a
H
G
k
G
G
a
k
O
j
o
o
n
k
O
O
a
a
a
O
O
g
"}
(19,1,1) = {"
g
d
P
O
G
G
z
z
z
O
k
O
j
o
o
n
P
P
B
a
a
a
O
O
g
"}
(20,1,1) = {"
g
k
p
f
k
G
z
z
P
s
O
j
j
o
o
n
O
G
a
a
a
a
O
s
g
"}
(21,1,1) = {"
g
O
p
k
P
G
G
G
z
O
k
j
j
o
o
n
n
O
u
a
G
B
O
O
g
"}
(22,1,1) = {"
t
O
k
a
U
G
k
H
G
a
k
O
j
o
o
n
k
k
O
a
a
a
O
O
g
"}
(23,1,1) = {"
g
O
G
G
G
O
O
O
a
G
a
O
j
o
o
n
n
k
c
k
a
a
Y
O
g
"}
(24,1,1) = {"
g
O
O
a
O
O
Y
k
k
G
O
O
j
o
o
n
k
k
k
f
P
G
O
O
g
"}
(25,1,1) = {"
g
g
g
g
g
g
g
g
g
g
g
j
j
o
o
n
g
g
g
g
g
g
g
g
g
"}
