//MAP CONVERTED BY dmm2tgm.py THIS HEADER COMMENT PREVENTS RECONVERSION, DO NOT REMOVE
"a" = (
/turf/open/floor/churchbrick,
/area/indoors/cave)
"b" = (
/turf/open/openspace,
/area/indoors/cave)
"g" = (
/turf/closed/mineral,
/area/indoors/cave)
"j" = (
/turf/open/water/river,
/area/indoors/cave)
"n" = (
/turf/open/water/river{
	dir = 1
	},
/area/indoors/cave)
"o" = (
/turf/open/water/river{
	dir = 8
	},
/area/indoors/cave)
"O" = (
/turf/open/floor/tile/bath,
/area/indoors/cave)
"R" = (
/turf/open/water/river{
	dir = 4
	},
/area/indoors/cave)

(1,1,1) = {"
g
g
g
g
g
g
g
g
g
g
j
j
R
R
R
n
g
g
g
g
g
g
g
g
g
"}
(2,1,1) = {"
g
O
O
O
a
a
a
a
O
O
O
j
R
R
R
n
O
a
a
a
a
a
a
O
g
"}
(3,1,1) = {"
g
O
O
a
a
a
a
a
a
O
O
j
R
R
R
n
n
a
a
a
a
a
a
O
g
"}
(4,1,1) = {"
g
O
O
a
a
a
a
a
a
O
O
j
R
R
R
n
n
a
a
a
a
a
a
O
g
"}
(5,1,1) = {"
g
O
a
a
a
a
a
a
a
a
O
j
R
R
R
n
O
a
a
a
a
a
a
O
g
"}
(6,1,1) = {"
g
O
a
a
a
a
a
a
a
a
O
j
R
R
R
n
O
a
a
a
a
a
a
O
g
"}
(7,1,1) = {"
g
O
a
a
a
a
a
a
a
a
O
j
R
R
R
n
O
a
a
a
a
a
a
O
g
"}
(8,1,1) = {"
g
O
O
a
a
a
a
a
a
O
O
j
R
R
R
n
n
a
a
a
a
a
a
O
g
"}
(9,1,1) = {"
g
O
O
a
a
a
a
a
a
O
j
j
R
R
R
n
O
a
a
a
a
a
a
O
g
"}
(10,1,1) = {"
R
R
R
O
a
a
a
a
O
O
O
j
R
R
R
n
R
R
R
R
R
R
R
R
R
"}
(11,1,1) = {"
j
j
R
O
O
R
O
O
O
O
j
R
R
R
R
R
n
n
n
n
n
n
n
n
n
"}
(12,1,1) = {"
j
j
R
R
R
R
R
R
R
R
j
b
b
b
b
b
n
n
n
n
n
n
n
n
n
"}
(13,1,1) = {"
j
j
j
j
j
j
j
j
j
j
j
b
b
b
b
b
n
n
n
n
n
n
n
n
n
"}
(14,1,1) = {"
j
j
j
j
j
j
j
j
j
j
j
b
b
b
b
b
n
n
n
n
n
n
n
n
n
"}
(15,1,1) = {"
j
j
j
j
j
j
j
j
j
j
j
b
b
b
b
b
n
n
n
n
n
n
n
n
n
"}
(16,1,1) = {"
o
O
o
a
o
o
o
o
o
a
j
o
o
o
o
o
n
n
n
o
o
a
o
o
o
"}
(17,1,1) = {"
g
O
a
a
a
O
o
O
a
a
a
O
j
o
o
n
O
o
o
o
a
a
o
o
o
"}
(18,1,1) = {"
g
O
O
a
a
a
O
a
a
a
O
O
j
o
o
n
O
O
O
a
a
a
O
O
g
"}
(19,1,1) = {"
g
O
O
O
a
a
a
a
a
O
O
O
j
o
o
n
O
O
a
a
a
a
O
O
g
"}
(20,1,1) = {"
g
O
O
O
O
a
a
a
O
O
O
j
j
o
o
n
O
a
a
a
a
a
O
O
g
"}
(21,1,1) = {"
g
O
O
O
O
a
a
a
a
O
O
j
j
o
o
n
n
O
a
a
a
a
O
O
g
"}
(22,1,1) = {"
g
O
O
a
a
a
O
a
a
a
O
O
j
o
o
n
O
O
O
a
a
a
O
O
g
"}
(23,1,1) = {"
g
O
a
a
a
O
O
O
a
a
a
O
j
o
o
n
n
O
O
O
a
a
O
O
g
"}
(24,1,1) = {"
g
O
O
a
O
O
O
O
O
a
O
O
j
o
o
n
O
O
O
O
O
a
O
O
g
"}
(25,1,1) = {"
g
g
g
g
g
g
g
g
g
g
g
j
j
o
o
n
g
g
g
g
g
g
g
g
g
"}
