//MAP CONVERTED BY dmm2tgm.py THIS HEADER COMMENT PREVENTS RECONVERSION, DO NOT REMOVE
"o" = (
/obj/effect/landmark/map_load_mark/necropolis/z3_corridors,
/turf/closed/dungeon_void,
/area/under/necropolis)
"r" = (
/turf/closed/dungeon_void,
/area/under/necropolis)
"S" = (
/obj/effect/spawner/map_spawner/necropolis/random_rock_wall,
/turf/open/floor/church/rust,
/area/under/necropolis)

(1,1,1) = {"
r
r
r
r
r
r
r
r
r
r
r
o
S
r
r
r
r
r
r
r
r
r
r
r
o
"}
(2,1,1) = {"
r
r
r
r
r
r
r
r
r
r
r
r
S
r
r
r
r
r
r
r
r
r
r
r
r
"}
(3,1,1) = {"
r
r
r
r
r
r
r
r
r
r
r
r
S
r
r
r
r
r
r
r
r
r
r
r
r
"}
(4,1,1) = {"
r
r
r
r
r
r
r
r
r
r
r
r
S
r
r
r
r
r
r
r
r
r
r
r
r
"}
(5,1,1) = {"
r
r
r
r
r
r
r
r
r
r
r
r
S
r
r
r
r
r
r
r
r
r
r
r
r
"}
(6,1,1) = {"
r
r
r
r
r
r
r
r
r
r
r
r
S
r
r
r
r
r
r
r
r
r
r
r
r
"}
(7,1,1) = {"
r
r
r
r
r
r
r
r
r
r
r
r
S
r
r
r
r
r
r
r
r
r
r
r
r
"}
(8,1,1) = {"
r
r
r
r
r
r
r
r
r
r
r
r
S
r
r
r
r
r
r
r
r
r
r
r
r
"}
(9,1,1) = {"
r
r
r
r
r
r
r
r
r
r
r
r
S
r
r
r
r
r
r
r
r
r
r
r
r
"}
(10,1,1) = {"
r
r
r
r
r
r
r
r
r
r
r
r
S
r
r
r
r
r
r
r
r
r
r
r
r
"}
(11,1,1) = {"
r
r
r
r
r
r
r
r
r
r
r
r
S
r
r
r
r
r
r
r
r
r
r
r
r
"}
(12,1,1) = {"
r
r
r
r
r
r
r
r
r
r
r
r
S
r
r
r
r
r
r
r
r
r
r
r
r
"}
(13,1,1) = {"
S
S
S
S
S
S
S
S
S
S
S
S
S
S
S
S
S
S
S
S
S
S
S
S
S
"}
(14,1,1) = {"
r
r
r
r
r
r
r
r
r
r
r
o
S
r
r
r
r
r
r
r
r
r
r
r
o
"}
(15,1,1) = {"
r
r
r
r
r
r
r
r
r
r
r
r
S
r
r
r
r
r
r
r
r
r
r
r
r
"}
(16,1,1) = {"
r
r
r
r
r
r
r
r
r
r
r
r
S
r
r
r
r
r
r
r
r
r
r
r
r
"}
(17,1,1) = {"
r
r
r
r
r
r
r
r
r
r
r
r
S
r
r
r
r
r
r
r
r
r
r
r
r
"}
(18,1,1) = {"
r
r
r
r
r
r
r
r
r
r
r
r
S
r
r
r
r
r
r
r
r
r
r
r
r
"}
(19,1,1) = {"
r
r
r
r
r
r
r
r
r
r
r
r
S
r
r
r
r
r
r
r
r
r
r
r
r
"}
(20,1,1) = {"
r
r
r
r
r
r
r
r
r
r
r
r
S
r
r
r
r
r
r
r
r
r
r
r
r
"}
(21,1,1) = {"
r
r
r
r
r
r
r
r
r
r
r
r
S
r
r
r
r
r
r
r
r
r
r
r
r
"}
(22,1,1) = {"
r
r
r
r
r
r
r
r
r
r
r
r
S
r
r
r
r
r
r
r
r
r
r
r
r
"}
(23,1,1) = {"
r
r
r
r
r
r
r
r
r
r
r
r
S
r
r
r
r
r
r
r
r
r
r
r
r
"}
(24,1,1) = {"
r
r
r
r
r
r
r
r
r
r
r
r
S
r
r
r
r
r
r
r
r
r
r
r
r
"}
(25,1,1) = {"
r
r
r
r
r
r
r
r
r
r
r
r
S
r
r
r
r
r
r
r
r
r
r
r
r
"}
