//MAP CONVERTED BY dmm2tgm.py THIS HEADER COMMENT PREVENTS RECONVERSION, DO NOT REMOVE
"a" = (
/turf/closed/wall/mineral/stone/moss,
/area/under/necropolis)
"b" = (
/obj/machinery/light/fueledstreet/orange/wall{
	dir = 8
	},
/turf/open/floor/church/rust,
/area/under/necropolis)
"c" = (
/obj/structure/fluff/railing/border,
/obj/effect/spawner/map_spawner/necropolis/random_dirty,
/turf/open/floor/church/pale,
/area/under/necropolis)
"d" = (
/obj/item/natural/rock/random,
/turf/open/floor/church/pale,
/area/under/necropolis)
"e" = (
/turf/open/water/ocean,
/area/under/necropolis)
"f" = (
/obj/structure/fluff/railing/border,
/turf/open/floor/church/pale,
/area/under/necropolis)
"g" = (
/obj/structure/fluid_drain,
/turf/open/floor/church/rust,
/area/under/necropolis)
"h" = (
/obj/structure/fluff/railing/border{
	dir = 8
	},
/turf/open/floor/church/gold,
/area/under/necropolis)
"i" = (
/obj/effect/spawner/map_spawner/necropolis,
/turf/open/floor/church/pale,
/area/under/necropolis)
"j" = (
/obj/structure/fluff/railing/border{
	dir = 1
	},
/obj/structure/fluff/railing/border{
	dir = 6
	},
/obj/effect/spawner/map_spawner/necropolis/random_dirty,
/turf/open/floor/church/green,
/area/under/necropolis)
"k" = (
/obj/structure/fluff/railing/border,
/obj/structure/fluff/railing/border{
	dir = 5
	},
/turf/open/floor/church/rust,
/area/under/necropolis)
"l" = (
/obj/effect/spawner/map_spawner/necropolis/random_dirty,
/turf/open/floor/church/rust,
/area/under/necropolis)
"m" = (
/obj/effect/spawner/map_spawner/necropolis/random_dirty,
/turf/open/floor/church/pale,
/area/under/necropolis)
"n" = (
/turf/closed/wall/mineral/pipe,
/area/under/necropolis)
"o" = (
/obj/effect/spawner/map_spawner/necropolis/water_clutter,
/turf/open/water/ocean,
/area/under/necropolis)
"p" = (
/obj/effect/spawner/map_spawner/necropolis/water_tiles,
/turf/open/floor/church/pale,
/area/under/necropolis)
"q" = (
/obj/structure/fluff/railing/border,
/turf/open/floor/church/rust,
/area/under/necropolis)
"r" = (
/obj/structure/bars,
/turf/open/floor/metal,
/area/under/necropolis)
"s" = (
/obj/effect/spawner/map_spawner/loot/common,
/turf/open/floor/church/pale,
/area/under/necropolis)
"t" = (
/turf/closed/wall/mineral/stone/moss/red,
/area/under/necropolis)
"u" = (
/obj/effect/waterfall,
/turf/open/water/ocean,
/area/under/necropolis)
"v" = (
/obj/structure/fluff/railing/border{
	dir = 10
	},
/obj/effect/landmark/map_load_mark/necropolis/z3_pillars,
/turf/open/floor/church/pale,
/area/under/necropolis)
"w" = (
/obj/effect/spawner/map_spawner/necropolis/random_rock_wall,
/turf/open/floor/church/rust,
/area/under/necropolis)
"x" = (
/obj/structure/bars,
/turf/open/floor/metal/alt,
/area/under/necropolis)
"y" = (
/turf/open/floor/church/rust,
/area/under/necropolis)
"z" = (
/obj/effect/spawner/map_spawner/necropolis,
/turf/open/floor/church/rust,
/area/under/necropolis)
"A" = (
/obj/structure/fluff/railing/border{
	dir = 5
	},
/obj/effect/spawner/map_spawner/necropolis/random_dirty,
/turf/open/floor/church/rust,
/area/under/necropolis)
"B" = (
/obj/structure/fluff/railing/border{
	dir = 1
	},
/obj/structure/fluff/railing/border{
	dir = 10
	},
/obj/effect/spawner/map_spawner/necropolis,
/turf/open/floor/church/rust,
/area/under/necropolis)
"C" = (
/obj/structure/fluff/steamvent,
/turf/open/floor/church/green,
/area/under/necropolis)
"D" = (
/obj/structure/fluff/railing/border,
/obj/effect/spawner/map_spawner/necropolis,
/turf/open/floor/church/rust,
/area/under/necropolis)
"E" = (
/obj/structure/fluid_drain,
/turf/open/floor/church/green,
/area/under/necropolis)
"F" = (
/obj/structure/fluff/railing/border,
/obj/structure/fluff/railing/border{
	dir = 9
	},
/turf/open/floor/church/green,
/area/under/necropolis)
"G" = (
/obj/effect/landmark/map_load_mark/necropolis/z3_pillars,
/turf/open/water/ocean,
/area/under/necropolis)
"H" = (
/obj/structure/fluff/steamvent,
/turf/open/floor/church/pale,
/area/under/necropolis)
"I" = (
/obj/effect/landmark/map_load_mark/necropolis/z3_pillars,
/turf/closed/wall/mineral/stone/moss/blue,
/area/under/necropolis)
"J" = (
/obj/structure/fluff/railing/border{
	dir = 9
	},
/obj/effect/spawner/map_spawner/necropolis/water_tiles,
/turf/open/floor/church/gold,
/area/under/necropolis)
"K" = (
/obj/effect/waterfall,
/obj/effect/spawner/map_spawner/necropolis/water_clutter,
/turf/open/water/ocean,
/area/under/necropolis)
"L" = (
/obj/effect/spawner/map_spawner/necropolis/water_tiles,
/turf/open/floor/church/rust,
/area/under/necropolis)
"M" = (
/turf/closed/wall/mineral/stone/moss/blue,
/area/under/necropolis)
"N" = (
/obj/structure/fluff/railing/border{
	dir = 8
	},
/turf/open/floor/church/rust,
/area/under/necropolis)
"O" = (
/obj/effect/spawner/map_spawner/necropolis/shroom_clutter,
/turf/open/floor/church/rust,
/area/under/necropolis)
"P" = (
/obj/structure/fluff/railing/border,
/obj/effect/spawner/map_spawner/necropolis/random_dirty,
/turf/open/floor/church/green,
/area/under/necropolis)
"Q" = (
/obj/structure/fluff/railing/border{
	dir = 1
	},
/obj/effect/spawner/map_spawner/necropolis/random_dirty,
/turf/open/floor/church/green,
/area/under/necropolis)
"R" = (
/obj/machinery/light/fueledstreet/orange/wall{
	dir = 4
	},
/obj/effect/spawner/map_spawner/necropolis/random_dirty,
/turf/open/floor/church/pale,
/area/under/necropolis)
"S" = (
/obj/structure/fluff/railing/border,
/obj/effect/spawner/map_spawner/necropolis/random_dirty,
/turf/open/floor/church/rust,
/area/under/necropolis)
"T" = (
/obj/structure/fluff/railing/border{
	dir = 4
	},
/obj/effect/spawner/map_spawner/necropolis/random_dirty,
/turf/open/floor/church/rust,
/area/under/necropolis)
"U" = (
/obj/effect/spawner/map_spawner/necropolis/water_tiles,
/turf/open/floor/church/gold,
/area/under/necropolis)
"V" = (
/obj/structure/fluff/steamvent,
/turf/open/floor/church/rust,
/area/under/necropolis)
"W" = (
/obj/structure/fluff/railing/border{
	dir = 1
	},
/turf/open/floor/church/rust,
/area/under/necropolis)
"X" = (
/obj/effect/spawner/map_spawner/necropolis/random_rock_wall,
/turf/open/floor/church/green,
/area/under/necropolis)
"Y" = (
/obj/effect/spawner/map_spawner/necropolis/water_tiles,
/turf/open/floor/church/green,
/area/under/necropolis)
"Z" = (
/obj/effect/spawner/map_spawner/necropolis/random_rock_wall,
/turf/open/floor/church/pale,
/area/under/necropolis)

(1,1,1) = {"
a
a
a
I
M
L
z
Z
a
a
a
a
"}
(2,1,1) = {"
a
a
u
o
a
O
V
l
a
e
o
a
"}
(3,1,1) = {"
a
a
K
e
x
b
L
s
f
o
e
a
"}
(4,1,1) = {"
a
a
r
r
a
n
n
a
k
e
o
a
"}
(5,1,1) = {"
X
w
m
c
o
e
e
G
B
N
h
J
"}
(6,1,1) = {"
X
E
Y
D
e
o
e
o
W
O
g
U
"}
(7,1,1) = {"
y
C
Y
P
e
e
e
e
Q
l
V
z
"}
(8,1,1) = {"
z
y
O
S
o
e
e
o
j
T
T
A
"}
(9,1,1) = {"
a
a
r
v
a
n
n
a
F
o
e
t
"}
(10,1,1) = {"
a
t
r
s
p
m
R
d
q
e
e
a
"}
(11,1,1) = {"
a
a
r
r
M
p
H
i
a
e
o
a
"}
(12,1,1) = {"
a
a
a
a
M
L
L
O
a
a
a
a
"}
