//MAP CONVERTED BY dmm2tgm.py THIS HEADER COMMENT PREVENTS RECONVERSION, DO NOT REMOVE
"a" = (
/turf/closed/wall/mineral/stone/moss,
/area/under/necropolis)
"b" = (
/obj/effect/spawner/map_spawner/sewerencounter,
/turf/open/floor/church/pale,
/area/under/necropolis)
"c" = (
/obj/effect/spawner/map_spawner/necropolis/water_clutter,
/turf/open/water/river/sewer,
/area/under/necropolis)
"d" = (
/obj/effect/spawner/map_spawner/necropolis/shroom_clutter,
/turf/open/floor/church/green,
/area/under/necropolis)
"e" = (
/obj/structure/stairs/stone,
/obj/structure/fluff/railing/border{
	dir = 4
	},
/turf/open/floor/church/gold,
/area/under/necropolis)
"f" = (
/obj/structure/stairs/stone{
	dir = 1
	},
/obj/structure/fluff/railing/border{
	dir = 8
	},
/turf/open/floor/church/pale,
/area/under/necropolis)
"g" = (
/obj/structure/fluid_drain,
/obj/effect/spawner/map_spawner/necropolis/random_dirty,
/turf/open/floor/church/rust,
/area/under/necropolis)
"i" = (
/obj/effect/spawner/map_spawner/sewerencounter,
/obj/effect/spawner/map_spawner/necropolis/random_dirty,
/turf/open/floor/naturalstone,
/area/under/necropolis)
"j" = (
/obj/effect/spawner/map_spawner/necropolis/shroom_clutter,
/obj/effect/spawner/map_spawner/necropolis/random_dirty,
/turf/open/floor/naturalstone,
/area/under/necropolis)
"k" = (
/obj/effect/spawner/map_spawner/necropolis/water_tiles,
/turf/open/floor/church/rust,
/area/under/necropolis)
"l" = (
/obj/effect/spawner/map_spawner/necropolis/water_tiles,
/turf/open/floor/church/pale,
/area/under/necropolis)
"m" = (
/turf/open/floor/church/pale,
/area/under/necropolis)
"n" = (
/turf/closed/wall/mineral/pipe,
/area/under/necropolis)
"o" = (
/obj/effect/spawner/map_spawner/necropolis/random_rock_wall,
/turf/open/floor/church/gold,
/area/under/necropolis)
"p" = (
/obj/effect/spawner/map_spawner/necropolis/random_rock_wall,
/turf/open/floor/naturalstone,
/area/under/necropolis)
"q" = (
/obj/effect/spawner/map_spawner/necropolis/random_rock_wall,
/turf/open/floor/church/rust,
/area/under/necropolis)
"r" = (
/obj/structure/bars,
/turf/open/floor/church/rust,
/area/under/necropolis)
"s" = (
/turf/open/floor/naturalstone,
/area/under/necropolis)
"t" = (
/turf/closed/wall/mineral/stone/moss/red,
/area/under/necropolis)
"u" = (
/turf/closed/mineral,
/area/under/necropolis)
"v" = (
/obj/structure/fluid_drain,
/turf/open/floor/church/green,
/area/under/necropolis)
"w" = (
/obj/effect/spawner/map_spawner/necropolis/shroom_clutter,
/turf/open/floor/church/rust,
/area/under/necropolis)
"x" = (
/obj/effect/spawner/map_spawner/loot/common,
/obj/effect/spawner/map_spawner/necropolis/random_dirty,
/turf/open/floor/church/rust,
/area/under/necropolis)
"y" = (
/turf/open/floor/church/rust,
/area/under/necropolis)
"A" = (
/obj/effect/spawner/map_spawner/necropolis,
/obj/effect/spawner/map_spawner/necropolis/random_dirty,
/turf/open/floor/church/pale,
/area/under/necropolis)
"B" = (
/obj/structure/fluff/railing/border{
	dir = 4
	},
/turf/open/floor/church/gold,
/area/under/necropolis)
"C" = (
/obj/effect/spawner/map_spawner/necropolis/shroom_clutter,
/obj/effect/spawner/map_spawner/necropolis/random_dirty,
/turf/open/floor/church/pale,
/area/under/necropolis)
"D" = (
/obj/effect/landmark/map_load_mark/necropolis/z3_pillars,
/turf/open/floor/church/pale,
/area/under/necropolis)
"E" = (
/obj/effect/spawner/map_spawner/necropolis,
/turf/open/floor/church/green,
/area/under/necropolis)
"F" = (
/obj/effect/landmark/map_load_mark/necropolis/z3_pillars,
/turf/closed/wall/mineral/stone/moss/blue,
/area/under/necropolis)
"G" = (
/obj/effect/spawner/map_spawner/necropolis/random_dirty,
/turf/open/floor/church/rust,
/area/under/necropolis)
"H" = (
/obj/structure/bars,
/turf/open/floor/church/pale,
/area/under/necropolis)
"I" = (
/obj/effect/spawner/map_spawner/necropolis/water_tiles,
/turf/open/floor/church/green,
/area/under/necropolis)
"J" = (
/obj/effect/spawner/map_spawner/necropolis/random_rock_wall,
/turf/open/floor/church/pale,
/area/under/necropolis)
"K" = (
/obj/structure/stairs/stone,
/obj/structure/fluff/railing/border{
	dir = 8
	},
/obj/effect/spawner/map_spawner/necropolis/random_dirty,
/turf/open/floor/church/rust,
/area/under/necropolis)
"L" = (
/obj/effect/spawner/map_spawner/necropolis,
/turf/open/floor/church/rust,
/area/under/necropolis)
"M" = (
/turf/closed/wall/mineral/stone/moss/blue,
/area/under/necropolis)
"N" = (
/obj/effect/spawner/map_spawner/necropolis/random_rock_wall,
/obj/effect/spawner/map_spawner/necropolis/random_dirty,
/turf/open/floor/church/pale,
/area/under/necropolis)
"O" = (
/obj/effect/spawner/map_spawner/necropolis/shroom_clutter,
/obj/effect/spawner/map_spawner/necropolis/random_dirty,
/turf/open/floor/church/rust,
/area/under/necropolis)
"P" = (
/obj/structure/stairs/stone{
	dir = 1
	},
/obj/structure/fluff/railing/border{
	dir = 4
	},
/turf/open/floor/church/gold,
/area/under/necropolis)
"Q" = (
/obj/effect/spawner/map_spawner/necropolis/water_tiles,
/obj/effect/spawner/map_spawner/necropolis/random_dirty,
/turf/open/floor/church/pale,
/area/under/necropolis)
"R" = (
/obj/structure/fluff/railing/border{
	dir = 8
	},
/obj/effect/spawner/map_spawner/necropolis/random_dirty,
/turf/open/floor/church/gold,
/area/under/necropolis)
"S" = (
/obj/effect/spawner/map_spawner/necropolis/random_dirty,
/turf/open/floor/naturalstone,
/area/under/necropolis)
"T" = (
/obj/effect/spawner/map_spawner/sewerencounter,
/turf/open/floor/church/rust,
/area/under/necropolis)
"U" = (
/obj/effect/spawner/map_spawner/necropolis/random_dirty,
/turf/open/floor/church/gold,
/area/under/necropolis)
"V" = (
/turf/open/water/river/sewer,
/area/under/necropolis)
"Y" = (
/turf/open/floor/church/green,
/area/under/necropolis)
"Z" = (
/obj/effect/spawner/map_spawner/necropolis,
/obj/effect/spawner/map_spawner/necropolis/random_dirty,
/turf/open/floor/church/rust,
/area/under/necropolis)

(1,1,1) = {"
a
a
a
M
F
G
O
J
a
a
a
a
"}
(2,1,1) = {"
a
k
k
G
Z
k
k
b
m
J
a
a
"}
(3,1,1) = {"
a
k
k
a
n
n
n
a
m
a
a
a
"}
(4,1,1) = {"
a
S
G
a
M
a
M
M
L
a
a
a
"}
(5,1,1) = {"
p
j
g
e
B
B
B
P
G
S
U
o
"}
(6,1,1) = {"
I
I
E
r
V
c
c
H
G
i
S
o
"}
(7,1,1) = {"
k
I
Y
r
c
V
V
H
d
E
s
s
"}
(8,1,1) = {"
k
T
q
K
R
R
R
f
v
G
G
w
"}
(9,1,1) = {"
a
y
u
y
n
n
n
D
I
I
u
t
"}
(10,1,1) = {"
a
L
u
u
x
A
C
J
k
u
u
a
"}
(11,1,1) = {"
a
y
u
u
k
Q
l
N
a
u
u
a
"}
(12,1,1) = {"
a
a
a
a
M
k
k
L
a
a
a
a
"}
