//MAP CONVERTED BY dmm2tgm.py THIS HEADER COMMENT PREVENTS RECONVERSION, DO NOT REMOVE
"e" = (
/obj/effect/spawner/map_spawner/necropolis/random_rock_wall,
/turf/open/floor/naturalstone,
/area/under/necropolis)
"f" = (
/turf/open/floor/naturalstone,
/area/under/necropolis)
"g" = (
/obj/effect/landmark/map_load_mark/necropolis/z3_corridors,
/turf/closed/mineral,
/area/under/necropolis)
"n" = (
/turf/open/floor/church/rust,
/area/under/necropolis)
"o" = (
/obj/effect/landmark/map_load_mark/necropolis/z3_corridors,
/turf/closed/mineral/random/low_nonval,
/area/under/necropolis)
"q" = (
/turf/closed/mineral/random/low_nonval,
/area/under/necropolis)
"r" = (
/turf/closed/mineral,
/area/under/necropolis)
"S" = (
/obj/effect/spawner/map_spawner/necropolis/random_rock_wall,
/turf/open/floor/church/rust,
/area/under/necropolis)

(1,1,1) = {"
q
q
q
r
r
r
f
f
r
r
r
g
S
q
q
q
q
q
f
f
f
r
r
r
g
"}
(2,1,1) = {"
q
q
r
r
r
r
r
r
q
r
r
r
S
q
q
q
q
q
r
r
r
r
r
r
r
"}
(3,1,1) = {"
q
r
r
r
r
r
r
r
q
r
r
r
e
q
q
q
q
q
q
r
r
r
r
r
r
"}
(4,1,1) = {"
q
r
r
r
r
q
r
r
r
r
r
q
e
n
q
q
q
q
q
r
r
r
r
r
f
"}
(5,1,1) = {"
f
r
r
r
q
q
r
r
r
r
r
q
e
f
r
q
q
q
q
r
r
r
r
r
f
"}
(6,1,1) = {"
f
r
r
q
q
q
q
f
f
r
q
n
e
f
r
r
r
r
r
r
r
r
r
r
n
"}
(7,1,1) = {"
q
r
r
r
q
q
f
f
f
r
q
n
e
r
r
r
r
r
q
q
q
r
r
r
q
"}
(8,1,1) = {"
r
r
r
r
r
r
r
f
f
r
q
n
e
r
r
r
r
r
q
q
q
r
r
r
r
"}
(9,1,1) = {"
r
r
r
r
r
r
r
r
r
r
r
q
e
r
r
r
r
r
q
q
q
r
r
r
r
"}
(10,1,1) = {"
r
r
r
r
r
r
r
r
q
r
r
r
S
q
r
r
r
r
r
r
r
r
r
q
q
"}
(11,1,1) = {"
r
r
r
r
r
r
r
q
q
r
r
r
S
q
q
r
r
f
f
r
r
r
r
q
q
"}
(12,1,1) = {"
r
r
f
f
r
q
q
q
q
q
q
q
S
q
q
q
r
n
n
f
q
q
q
q
q
"}
(13,1,1) = {"
e
S
S
S
S
S
e
e
S
S
S
S
S
S
S
S
S
e
S
S
S
e
e
S
e
"}
(14,1,1) = {"
r
r
r
r
f
f
f
f
f
r
r
g
S
q
q
q
q
r
f
f
r
q
q
q
o
"}
(15,1,1) = {"
r
r
r
r
r
r
r
r
r
r
r
r
S
q
q
q
q
r
r
f
r
r
r
q
q
"}
(16,1,1) = {"
r
r
r
r
r
q
r
r
r
r
r
r
S
q
q
r
r
r
r
r
r
r
r
q
q
"}
(17,1,1) = {"
r
r
r
q
q
q
q
r
r
r
r
n
e
q
r
r
r
r
r
r
r
r
r
r
q
"}
(18,1,1) = {"
f
r
r
r
q
q
r
f
r
r
r
n
e
r
r
r
r
r
r
r
q
r
r
r
q
"}
(19,1,1) = {"
f
r
r
r
r
r
f
f
r
r
r
q
e
r
r
r
r
r
q
q
q
q
r
r
q
"}
(20,1,1) = {"
f
r
r
r
r
f
f
f
r
r
q
q
e
r
r
r
r
q
q
q
q
r
r
r
r
"}
(21,1,1) = {"
q
r
r
r
r
r
r
r
r
r
q
q
S
q
r
r
r
r
q
q
q
r
r
r
r
"}
(22,1,1) = {"
q
r
r
r
r
r
q
r
r
r
q
q
S
q
r
r
r
r
r
r
r
q
r
r
r
"}
(23,1,1) = {"
q
q
r
r
r
q
q
q
r
r
r
q
S
q
q
r
r
q
q
r
f
q
q
r
r
"}
(24,1,1) = {"
q
q
q
r
r
r
r
r
r
r
r
q
e
q
r
r
q
q
q
f
f
f
q
r
q
"}
(25,1,1) = {"
q
q
q
r
r
r
f
f
f
r
r
r
e
r
r
f
f
f
q
f
f
f
q
q
q
"}
