//MAP CONVERTED BY dmm2tgm.py THIS HEADER COMMENT PREVENTS RECONVERSION, DO NOT REMOVE
"a" = (
/obj/effect/spawner/map_spawner/necropolis/water_tiles,
/turf/open/floor/church/rust,
/area/under/necropolis)
"d" = (
/obj/effect/spawner/map_spawner/necropolis,
/turf/open/floor/church/rust,
/area/under/necropolis)
"h" = (
/obj/effect/spawner/map_spawner/necropolis/random_dirty,
/turf/open/floor/church/rust,
/area/under/necropolis)
"s" = (
/turf/open/floor/church/rust,
/area/under/necropolis)
"C" = (
/obj/effect/spawner/map_spawner/necropolis/shroom_clutter,
/turf/open/floor/church/rust,
/area/under/necropolis)
"F" = (
/obj/effect/spawner/map_spawner/necropolis/random_rock_wall,
/turf/open/floor/church/rust,
/area/under/necropolis)
"N" = (
/obj/effect/spawner/map_spawner/necropolis/random_dirty,
/obj/effect/spawner/map_spawner/necropolis/shroom_clutter,
/turf/open/floor/church/rust,
/area/under/necropolis)
"P" = (
/obj/effect/spawner/map_spawner/necropolis/random_dirty,
/obj/effect/spawner/map_spawner/necropolis,
/turf/open/floor/church/rust,
/area/under/necropolis)

(1,1,1) = {"
P
h
C
h
"}
(2,1,1) = {"
a
a
a
F
"}
(3,1,1) = {"
F
C
a
N
"}
(4,1,1) = {"
s
s
d
h
"}
