//MAP CONVERTED BY dmm2tgm.py THIS HEADER COMMENT PREVENTS RECONVERSION, DO NOT REMOVE
"a" = (
/turf/closed/mineral,
/area/under/necropolis)
"h" = (
/obj/effect/spawner/map_spawner/necropolis/random_dirty,
/obj/effect/spawner/map_spawner/necropolis/mob_spawner,
/turf/open/floor/naturalstone,
/area/under/necropolis)
"i" = (
/turf/open/floor/naturalstone,
/area/under/necropolis)
"r" = (
/obj/effect/spawner/map_spawner/pit,
/turf/open/floor/church/rust,
/area/under/necropolis)
"v" = (
/obj/effect/spawner/map_spawner/necropolis,
/turf/open/floor/church/rust,
/area/under/necropolis)
"H" = (
/obj/effect/spawner/map_spawner/necropolis/random_dirty,
/turf/open/floor/church/rust,
/area/under/necropolis)
"N" = (
/obj/effect/spawner/map_spawner/necropolis/random_dirty,
/turf/open/floor/naturalstone,
/area/under/necropolis)
"T" = (
/obj/effect/spawner/map_spawner/necropolis,
/turf/open/floor/naturalstone,
/area/under/necropolis)

(1,1,1) = {"
a
a
r
i
"}
(2,1,1) = {"
H
a
a
v
"}
(3,1,1) = {"
N
a
i
i
"}
(4,1,1) = {"
T
i
H
h
"}
