//MAP CONVERTED BY dmm2tgm.py THIS HEADER COMMENT PREVENTS RECONVERSION, DO NOT REMOVE
"a" = (
/turf/closed/mineral,
/area/under/cave)
"k" = (
/mob/living/simple_animal/pet/cat/cabbit{
	name = "cabbit emptycave"
	},
/turf/open/floor/naturalstone,
/area/under/cave)
"q" = (
/turf/open/floor/volcanic,
/area/under/cave)
"s" = (
/turf/open/floor/naturalstone,
/area/under/cave)
"t" = (
/obj/item/natural/rock/random_ore,
/turf/open/floor/volcanic,
/area/under/cave)
"u" = (
/obj/item/natural/rock/random_ore,
/turf/open/floor/naturalstone,
/area/under/cave)
"v" = (
/obj/structure/flora/rock,
/turf/open/floor/naturalstone,
/area/under/cave)
"w" = (
/turf/open/lava,
/area/under/cave)
"x" = (
/obj/item/natural/rock,
/turf/open/floor/volcanic,
/area/under/cave)
"V" = (
/obj/structure/fluff/walldeco/vinez,
/turf/open/floor/naturalstone,
/area/under/cave)
"X" = (
/obj/item/natural/rock,
/turf/open/floor/naturalstone,
/area/under/cave)
"Y" = (
/obj/structure/fluff/walldeco/vinez,
/turf/open/floor/volcanic,
/area/under/cave)

(1,1,1) = {"
a
a
a
a
a
a
a
a
a
a
a
s
s
s
s
a
a
a
a
a
a
a
a
a
a
"}
(2,1,1) = {"
a
a
a
a
a
a
a
a
a
a
s
s
s
s
s
a
a
a
a
a
a
a
a
a
a
"}
(3,1,1) = {"
a
a
a
a
a
a
a
a
a
s
s
v
s
s
s
s
V
a
a
a
a
a
a
a
a
"}
(4,1,1) = {"
a
a
a
a
a
a
a
a
a
s
s
s
s
s
s
s
s
a
a
a
a
a
a
a
a
"}
(5,1,1) = {"
a
a
a
a
a
a
a
a
V
s
s
s
s
s
u
s
s
s
s
a
a
a
a
a
a
"}
(6,1,1) = {"
a
a
a
a
a
a
a
a
V
s
s
s
s
s
s
a
s
X
s
V
a
a
a
a
a
"}
(7,1,1) = {"
a
a
a
a
a
a
a
a
s
s
s
s
q
q
a
a
a
s
s
s
a
a
a
a
a
"}
(8,1,1) = {"
a
a
a
a
a
a
a
s
s
s
s
t
q
w
a
a
a
s
s
s
a
a
a
a
a
"}
(9,1,1) = {"
a
a
a
a
V
V
s
s
s
s
s
q
w
w
q
a
s
s
v
s
s
s
a
a
a
"}
(10,1,1) = {"
a
s
s
s
s
s
s
s
u
q
q
w
w
w
w
q
q
s
s
s
s
s
a
a
a
"}
(11,1,1) = {"
s
s
s
X
s
s
s
s
q
q
q
w
w
w
w
q
q
q
s
s
s
s
s
s
a
"}
(12,1,1) = {"
s
s
s
s
s
s
s
s
q
q
q
q
w
w
w
w
a
a
s
s
u
s
s
s
s
"}
(13,1,1) = {"
s
s
s
s
s
s
s
s
s
a
a
q
q
q
w
a
a
s
s
s
s
s
X
s
s
"}
(14,1,1) = {"
s
s
s
s
s
v
s
s
a
a
a
q
q
q
q
q
s
s
s
s
s
s
s
s
s
"}
(15,1,1) = {"
a
a
a
a
a
V
q
q
a
a
s
s
s
q
x
s
s
s
u
s
s
s
s
s
a
"}
(16,1,1) = {"
a
a
a
a
a
a
Y
q
q
s
s
s
s
s
s
a
s
s
s
s
a
s
s
a
a
"}
(17,1,1) = {"
a
a
a
a
a
a
Y
q
q
q
s
s
u
s
a
a
a
s
s
s
a
a
a
a
a
"}
(18,1,1) = {"
a
a
a
a
a
a
Y
q
q
q
s
s
s
s
a
a
a
s
s
V
a
a
a
a
a
"}
(19,1,1) = {"
a
a
a
a
a
a
a
Y
q
s
s
s
s
s
s
s
s
s
V
a
a
a
a
a
a
"}
(20,1,1) = {"
a
a
a
a
a
a
a
a
a
a
a
s
s
s
s
s
s
V
a
a
a
a
a
a
a
"}
(21,1,1) = {"
a
a
a
a
a
a
a
a
k
a
a
V
s
X
s
s
a
a
a
a
a
a
a
a
a
"}
(22,1,1) = {"
a
a
a
a
a
a
a
a
a
a
a
V
s
s
s
s
a
a
a
a
a
a
a
a
a
"}
(23,1,1) = {"
a
a
a
a
a
a
a
a
a
a
a
V
s
s
s
a
a
a
a
a
a
a
a
a
a
"}
(24,1,1) = {"
a
a
a
a
a
a
a
a
a
a
a
a
s
s
s
a
a
a
a
a
a
a
a
a
a
"}
(25,1,1) = {"
a
a
a
a
a
a
a
a
a
a
a
a
s
s
s
a
a
a
a
a
a
a
a
a
a
"}
