//MAP CONVERTED BY dmm2tgm.py THIS HEADER COMMENT PREVENTS RECONVERSION, DO NOT REMOVE
"a" = (
/turf/template_noop,
/area/template_noop)
"E" = (
/obj/effect/spawner/map_spawner/necropolis/random_rock_wall,
/turf/open/floor/grass/cold,
/area/template_noop)
"K" = (
/turf/open/floor/grass/cold,
/area/template_noop)
"P" = (
/obj/effect/spawner/map_spawner/necropolis/random_rock_wall,
/turf/open/floor/dirt,
/area/template_noop)
"R" = (
/turf/open/water/marsh,
/area/template_noop)
"Y" = (
/turf/open/floor/dirt,
/area/template_noop)

(1,1,1) = {"
a
Y
a
a
a
a
a
a
a
a
a
a
a
a
"}
(2,1,1) = {"
P
P
Y
a
Y
Y
a
Y
Y
a
Y
Y
a
a
"}
(3,1,1) = {"
P
P
P
Y
K
Y
P
P
Y
Y
P
P
Y
a
"}
(4,1,1) = {"
P
P
Y
K
K
E
P
R
R
P
P
P
P
a
"}
(5,1,1) = {"
P
Y
Y
K
R
E
P
R
K
E
P
P
Y
a
"}
(6,1,1) = {"
a
Y
K
K
R
R
R
R
K
E
Y
Y
a
a
"}
(7,1,1) = {"
a
K
K
R
R
R
R
R
R
R
K
a
a
a
"}
(8,1,1) = {"
a
K
K
R
R
R
R
R
R
R
K
Y
Y
a
"}
(9,1,1) = {"
a
a
K
K
K
R
R
K
K
K
P
P
Y
a
"}
(10,1,1) = {"
a
Y
P
P
Y
K
K
K
a
K
P
P
P
Y
"}
(11,1,1) = {"
Y
P
P
P
E
K
K
K
a
Y
P
P
Y
Y
"}
(12,1,1) = {"
Y
P
P
Y
P
Y
Y
a
a
Y
P
P
Y
a
"}
(13,1,1) = {"
a
Y
P
Y
Y
a
a
a
a
a
Y
Y
a
a
"}
(14,1,1) = {"
a
a
a
a
a
a
a
a
a
a
a
a
a
a
"}
