//MAP CONVERTED BY dmm2tgm.py THIS HEADER COMMENT PREVENTS RECONVERSION, DO NOT REMOVE
"a" = (
/turf/template_noop,
/area/template_noop)
"c" = (
/obj/item/natural/stone,
/turf/template_noop,
/area/template_noop)
"e" = (
/turf/closed/mineral/coal,
/area/under/cave)
"x" = (
/turf/closed/mineral,
/area/under/cave)
"X" = (
/obj/item/natural/rock/coal,
/turf/template_noop,
/area/template_noop)

(1,1,1) = {"
a
a
a
c
a
a
a
a
a
a
a
a
a
a
"}
(2,1,1) = {"
a
a
a
a
a
a
a
a
a
x
x
x
a
a
"}
(3,1,1) = {"
a
a
a
a
a
X
a
a
a
a
e
x
x
a
"}
(4,1,1) = {"
a
a
a
a
a
e
e
c
a
a
e
e
x
a
"}
(5,1,1) = {"
a
a
a
e
x
e
e
x
x
a
a
x
a
a
"}
(6,1,1) = {"
a
a
a
x
x
x
x
x
x
a
a
a
a
a
"}
(7,1,1) = {"
a
a
e
x
x
e
x
x
e
x
a
a
a
a
"}
(8,1,1) = {"
a
a
e
e
x
e
x
e
e
x
a
a
a
a
"}
(9,1,1) = {"
a
a
a
e
x
x
x
x
x
a
a
a
a
a
"}
(10,1,1) = {"
a
c
a
a
e
e
x
a
a
a
a
c
a
a
"}
(11,1,1) = {"
a
a
a
a
a
a
a
a
a
X
a
a
a
a
"}
(12,1,1) = {"
a
a
X
a
a
a
a
a
a
a
a
a
a
a
"}
(13,1,1) = {"
a
a
a
a
a
a
a
a
a
a
a
a
a
a
"}
(14,1,1) = {"
a
a
a
a
a
a
a
a
a
a
a
a
a
a
"}
