//MAP CONVERTED BY dmm2tgm.py THIS HEADER COMMENT PREVENTS RECONVERSION, DO NOT REMOVE
"a" = (
/obj/item/flashlight/flare/torch/lantern,
/obj/machinery/light/fueled/wallfire/candle/l,
/obj/item/scomstone,
/obj/item/clothing/shoes/nobleboot,
/obj/item/clothing/gloves/leather/black,
/obj/item/clothing/gloves/leather,
/obj/structure/closet/crate/chest,
/turf/open/floor/carpet/royalblack,
/area/indoors/town/keep/hand)
"c" = (
/obj/structure/window/openclose{
	dir = 4
	},
/turf/open/floor/ruinedwood,
/area/indoors/town/keep/hand)
"d" = (
/obj/structure/door/violet{
	name = "Heir's Chambers"
	},
/obj/effect/mapping_helpers/access/locker,
/obj/effect/mapping_helpers/access/keyset/manor/hand,
/turf/open/floor/ruinedwood/two,
/area/indoors/town/keep/hand)
"j" = (
/turf/closed/wall/mineral/stonebrick,
/area/indoors/town/keep/hand)
"m" = (
/obj/machinery/light/fueled/wallfire/candle/l,
/turf/open/floor/ruinedwood/two,
/area/indoors/town/keep/hand)
"n" = (
/obj/structure/bed/inn/double,
/obj/item/bedsheet/fabric_double,
/turf/open/floor/ruinedwood,
/area/indoors/town/keep/hand)
"q" = (
/obj/structure/table/wood{
	dir = 8;
	icon_state = "longtable"
	},
/turf/open/floor/ruinedwood/two,
/area/indoors/town/keep/hand)
"r" = (
/turf/open/floor/carpet/royalblack,
/area/indoors/town/keep/hand)
"w" = (
/turf/open/floor/ruinedwood/two,
/area/indoors/town/keep/hand)
"y" = (
/obj/structure/table/wood{
	dir = 1;
	icon_state = "longtable"
	},
/obj/item/weapon/sword/sabre,
/turf/open/floor/carpet/royalblack,
/area/indoors/town/keep/hand)
"z" = (
/obj/structure/closet/crate/drawer/random,
/obj/structure/fake_machine/mail{
	mailtag = "Hand"
	},
/obj/structure/sign/property_sign/claim{
	pixel_y = 31;
	pixel_x = -11
	},
/turf/open/floor/ruinedwood/two,
/area/indoors/town/keep/hand)
"N" = (
/obj/machinery/light/fueled/wallfire{
	pixel_y = 32
	},
/turf/open/floor/carpet/royalblack,
/area/indoors/town/keep/hand)
"U" = (
/obj/structure/table/wood{
	dir = 4;
	icon_state = "longtable"
	},
/obj/item/reagent_containers/glass/bottle/redwine,
/turf/open/floor/ruinedwood/two,
/area/indoors/town/keep/hand)
"W" = (
/obj/structure/table/wood{
	icon_state = "longtable"
	},
/obj/item/paper/scroll,
/obj/item/natural/feather,
/turf/open/floor/carpet/royalblack,
/area/indoors/town/keep/hand)
"Y" = (
/obj/structure/chair/wood{
	dir = 8
	},
/turf/open/floor/ruinedwood/two,
/area/indoors/town/keep/hand)

(1,1,1) = {"
j
j
j
c
j
j
j
j
"}
(2,1,1) = {"
d
w
m
U
q
a
W
j
"}
(3,1,1) = {"
j
N
w
w
Y
r
y
j
"}
(4,1,1) = {"
j
z
w
w
w
r
n
j
"}
(5,1,1) = {"
j
j
j
d
j
j
j
j
"}
