//MAP CONVERTED BY dmm2tgm.py THIS HEADER COMMENT PREVENTS RECONVERSION, DO NOT REMOVE
"a" = (
/obj/structure/trophy/deer,
/obj/structure/table/wood,
/turf/open/floor/ruinedwood/two,
/area/indoors/town/keep/heir/heir1)
"b" = (
/turf/open/floor/ruinedwood/two,
/area/indoors/town/keep/heir/heir1)
"c" = (
/obj/structure/door/violet{
	name = "Heir's Chambers"
	},
/obj/effect/mapping_helpers/access/keyset/manor/general,
/obj/effect/mapping_helpers/access/locker,
/turf/open/floor/wood,
/area/indoors/town/keep/heir/heir1)
"f" = (
/obj/structure/door/violet{
	name = "Heir's Chambers"
	},
/obj/effect/mapping_helpers/access/keyset/manor/general,
/obj/effect/mapping_helpers/access/locker,
/turf/open/floor/ruinedwood/two,
/area/indoors/town/keep/heir/heir1)
"g" = (
/obj/structure/bed/inn/double,
/obj/item/bedsheet/fabric_double,
/turf/open/floor/carpet/royalblack,
/area/indoors/town/keep/heir/heir1)
"h" = (
/turf/open/floor/carpet/royalblack,
/area/indoors/town/keep/heir/heir1)
"n" = (
/obj/machinery/light/fueled/wallfire/candle/l,
/turf/open/floor/carpet/royalblack,
/area/indoors/town/keep/heir/heir1)
"o" = (
/obj/structure/window/openclose{
	dir = 8
	},
/turf/open/floor/ruinedwood,
/area/indoors/town/keep/heir/heir1)
"E" = (
/obj/machinery/light/fueled/wallfire{
	pixel_y = 32
	},
/turf/open/floor/carpet/royalblack,
/area/indoors/town/keep/heir/heir1)
"G" = (
/obj/structure/closet/crate/drawer/random,
/obj/machinery/light/fueled/wallfire/candle,
/turf/open/floor/ruinedwood/two,
/area/indoors/town/keep/heir/heir1)
"O" = (
/obj/structure/sign/property_sign/claim{
	pixel_x = 30
	},
/turf/open/floor/ruinedwood/two,
/area/indoors/town/keep/heir/heir1)
"P" = (
/obj/structure/chair/wood,
/turf/open/floor/carpet/royalblack,
/area/indoors/town/keep/heir/heir1)
"R" = (
/obj/item/scomstone,
/obj/structure/closet/crate/crafted_closet/inn,
/obj/item/clothing/gloves/leather/black,
/obj/item/clothing/shoes/nobleboot,
/obj/item/clothing/gloves/leather,
/turf/open/floor/carpet/royalblack,
/area/indoors/town/keep/heir/heir1)
"S" = (
/turf/closed/wall/mineral/stonebrick,
/area/indoors/town/keep/heir/heir1)
"W" = (
/obj/structure/table/wood,
/obj/item/reagent_containers/glass/cup/golden,
/obj/item/candle/yellow/lit{
	pixel_x = 8
	},
/turf/open/floor/carpet/royalblack,
/area/indoors/town/keep/heir/heir1)

(1,1,1) = {"
S
S
S
S
S
S
"}
(2,1,1) = {"
S
E
b
n
R
S
"}
(3,1,1) = {"
c
b
b
h
g
S
"}
(4,1,1) = {"
S
a
b
P
W
S
"}
(5,1,1) = {"
S
G
O
b
b
f
"}
(6,1,1) = {"
S
o
S
S
S
S
"}
